,Barrio,Censo,Abstención,Total,Nulos,Total no nulos,Blanco,Total no nulos no blancos,PP,PSOE,PODEMOS,CIUDADANOS,IUCM-LV,UPyD,ESPAÑA 2000,AES,ULEG,PCAS-TC,PLIB,LA COALICION NACIONAL,SAIN,PH,PCPE,FE DE LAS JONS,PACMA,RECORTES CERO,VOX
0,11,847,267,580,1,579,4,575,216,152,91,64,26,7,0,0,0,1,0,0,0,0,1,0,6,0,11
1,11,640,222,418,1,417,3,414,96,110,118,42,32,8,0,0,0,0,0,1,0,0,0,0,5,0,2
2,11,584,215,369,3,366,4,362,143,80,77,28,16,2,0,0,0,1,0,1,0,0,0,0,6,0,8
3,11,521,196,325,4,321,0,321,119,85,72,20,14,6,0,0,0,0,0,0,0,0,0,0,2,0,3
4,11,938,262,676,4,672,5,667,242,162,132,64,37,10,0,3,0,0,0,0,0,4,0,0,3,1,9
5,11,628,188,440,4,436,5,431,124,101,103,53,25,8,1,0,0,1,0,1,2,0,0,0,8,0,4
6,11,640,178,462,3,459,2,457,144,104,105,53,27,8,0,0,0,0,0,1,0,0,0,1,8,0,6
7,11,629,201,428,2,426,2,424,120,122,93,49,25,1,0,0,0,0,0,0,0,0,0,1,6,2,5
8,11,622,176,446,2,444,7,437,116,112,108,46,34,4,0,1,1,0,2,0,4,0,0,0,4,0,5
9,11,1014,284,730,6,724,4,720,225,186,169,69,20,23,0,1,0,0,0,0,0,1,0,1,14,1,10
10,11,815,244,571,5,566,6,560,152,149,172,33,30,8,0,0,0,0,0,2,0,0,0,0,4,3,7
11,11,599,192,407,2,405,5,400,120,80,118,35,24,4,1,0,0,0,0,0,0,1,0,0,4,5,8
12,11,852,278,574,4,570,8,562,117,153,187,37,50,7,0,0,0,0,0,1,0,1,1,0,5,1,2
13,11,515,131,384,3,381,4,377,87,97,122,28,23,9,0,0,0,0,0,0,0,1,1,0,6,0,3
14,11,523,133,390,2,388,1,387,99,101,101,46,26,7,0,0,0,0,0,0,0,0,0,0,3,0,4
15,11,661,225,436,2,434,2,432,112,134,101,33,33,5,0,0,0,0,1,2,0,2,2,0,3,0,4
16,11,570,218,352,2,350,0,350,88,95,106,32,21,5,0,0,0,0,0,0,0,0,0,0,1,1,1
17,11,790,201,589,2,587,7,580,141,164,161,41,40,10,0,1,0,0,0,0,0,0,2,1,9,2,8
18,11,694,226,468,3,465,5,460,146,116,102,42,31,8,0,0,0,1,0,0,0,0,0,0,7,0,7
19,11,713,205,508,6,502,10,492,146,125,111,45,37,13,0,0,0,0,1,1,0,0,1,0,6,1,5
20,11,1002,293,709,4,705,7,698,177,184,190,80,36,12,3,1,0,0,0,2,0,1,1,0,5,0,6
21,11,925,270,655,5,650,3,647,213,158,156,49,46,11,1,1,0,0,0,0,0,0,1,0,6,0,5
22,11,726,233,493,1,492,5,487,128,133,124,49,37,7,0,0,0,0,0,0,0,0,0,1,3,1,4
23,11,721,218,503,4,499,2,497,112,143,134,50,25,11,2,0,0,0,0,0,0,0,1,2,7,1,9
24,12,886,295,591,1,590,6,584,118,184,180,36,47,6,1,0,0,0,0,0,0,0,0,0,7,0,5
25,12,523,194,329,0,329,5,324,73,96,108,17,20,5,0,0,0,0,0,0,0,0,0,0,2,0,3
26,12,535,191,344,0,344,5,339,85,94,103,23,16,11,0,0,0,0,0,0,0,2,0,0,5,0,0
27,12,955,334,621,4,617,2,615,125,157,211,48,45,11,0,0,1,0,0,0,0,2,2,0,5,2,6
28,12,669,221,448,3,445,6,439,118,118,134,26,31,7,1,0,0,0,0,0,0,0,1,0,1,0,2
29,12,1020,348,672,3,669,4,665,171,187,193,63,32,7,2,0,0,0,0,0,0,0,1,1,5,0,3
30,12,835,272,563,4,559,4,555,129,155,142,68,37,8,0,2,0,0,0,0,1,1,0,1,5,3,3
31,12,943,338,605,1,604,2,602,115,135,265,40,29,6,0,0,0,0,0,0,1,0,1,0,7,0,3
32,12,896,358,538,3,535,8,527,93,124,196,46,44,14,0,0,0,1,0,0,0,1,1,0,0,5,2
33,12,695,278,417,3,414,1,413,98,111,130,37,24,5,0,0,0,2,0,0,0,1,0,0,5,0,0
34,12,834,362,472,3,469,1,468,76,146,161,32,36,8,0,0,0,0,0,1,0,0,0,0,4,1,3
35,12,723,226,497,8,489,2,487,78,142,156,46,35,14,0,0,0,1,0,0,0,0,0,0,8,2,5
36,12,655,211,444,6,438,7,431,94,103,139,36,37,13,0,0,0,0,0,0,0,0,0,0,6,0,3
37,12,906,355,551,2,549,5,544,112,125,205,32,52,10,0,0,0,0,0,2,0,1,0,0,3,1,1
38,12,838,373,465,3,462,3,459,79,112,194,26,29,7,0,0,0,3,0,3,0,0,1,1,4,0,0
39,12,976,369,607,6,601,5,596,107,160,214,36,56,11,0,2,0,1,0,0,0,1,2,0,4,0,2
40,12,797,282,515,3,512,5,507,79,139,209,29,36,4,0,1,0,0,1,0,0,0,0,0,8,1,0
41,12,776,252,524,3,521,6,515,118,113,186,36,36,11,0,1,0,0,0,0,0,0,1,0,5,3,5
42,12,745,298,447,4,443,2,441,84,106,168,20,37,11,0,0,0,1,0,0,0,0,0,0,11,1,2
43,12,692,273,419,0,419,4,415,79,113,141,26,35,9,1,0,0,1,0,0,0,0,1,0,4,1,4
44,12,521,180,341,2,339,3,336,89,67,115,22,31,4,1,0,0,0,0,1,0,0,0,0,2,0,4
45,12,636,223,413,1,412,4,408,95,112,130,26,32,5,0,1,0,0,0,2,1,2,0,1,0,0,1
46,12,706,240,466,4,462,2,460,107,100,181,30,21,9,1,0,0,1,0,0,0,0,0,1,3,0,6
47,12,690,260,430,2,428,2,426,51,117,188,25,26,9,0,0,0,1,1,0,0,0,0,3,3,0,2
48,12,916,304,612,5,607,2,605,98,180,212,40,54,7,0,0,0,0,0,0,0,1,0,1,11,0,1
49,12,586,218,368,2,366,2,364,64,105,126,26,26,3,0,0,0,0,0,1,0,0,0,3,4,0,6
50,12,503,173,330,2,328,4,324,56,87,130,20,21,5,0,0,0,1,1,1,0,0,0,0,1,0,1
51,12,694,247,447,3,444,3,441,68,115,178,28,37,7,0,2,0,0,0,0,0,2,1,0,3,0,0
52,12,683,254,429,0,429,1,428,79,98,178,33,23,5,0,0,0,1,0,0,0,1,1,1,5,2,1
53,12,830,291,539,3,536,6,530,99,135,222,23,33,9,0,0,0,1,0,0,0,1,0,0,4,0,3
54,12,826,291,535,6,529,4,525,110,134,197,32,34,6,0,0,0,0,0,1,0,1,0,1,8,0,1
55,12,893,350,543,6,537,4,533,110,109,213,39,42,5,0,1,0,0,1,0,0,1,2,1,5,3,1
56,12,893,339,554,2,552,2,550,89,129,224,34,48,6,0,0,0,0,0,0,0,2,0,0,11,1,6
57,12,955,334,621,4,617,14,603,111,168,200,48,50,9,0,0,0,2,0,0,0,0,1,2,5,1,6
58,12,637,206,431,3,428,2,426,106,108,141,20,34,3,0,0,0,0,0,0,0,1,0,0,5,2,6
59,12,804,262,542,2,540,2,538,140,131,162,42,40,10,0,0,0,0,0,0,0,0,1,1,8,1,2
60,12,688,203,485,6,479,7,472,134,100,159,32,31,7,0,0,0,0,0,0,0,0,0,0,5,0,4
61,12,583,168,415,3,412,6,406,166,77,78,34,25,9,0,2,0,0,0,0,0,0,0,0,4,0,11
62,12,592,182,410,7,403,1,402,149,99,83,27,24,4,0,0,0,0,0,0,0,0,0,0,0,2,14
63,12,545,158,387,0,387,5,382,123,81,103,31,28,6,0,0,0,0,1,0,0,0,1,2,4,1,1
64,12,547,210,337,1,336,1,335,81,87,99,30,26,3,0,0,0,0,0,0,0,0,0,1,1,3,4
65,12,529,185,344,3,341,0,341,92,89,98,28,19,7,0,0,0,0,0,0,0,0,0,0,5,1,2
66,13,599,195,404,2,402,5,397,118,96,103,43,23,7,1,0,0,0,1,0,0,1,0,0,3,0,1
67,13,789,247,542,2,540,7,533,134,149,128,44,41,12,0,0,0,0,0,0,2,1,1,2,8,2,9
68,13,562,167,395,1,394,2,392,131,101,95,33,22,6,0,0,1,0,0,1,0,0,0,0,0,0,2
69,13,576,177,399,1,398,5,393,111,119,89,41,23,2,0,0,0,0,0,1,0,0,0,1,3,1,2
70,13,586,184,402,1,401,3,398,97,90,122,26,44,10,0,0,0,0,0,0,0,1,0,0,4,1,3
71,13,526,219,307,2,305,2,303,87,71,72,24,26,7,0,0,0,0,0,0,1,0,1,1,8,2,3
72,13,539,232,307,3,304,5,299,72,83,85,35,19,2,0,1,0,0,0,0,0,0,0,0,1,1,0
73,13,780,258,522,4,518,2,516,151,127,143,42,24,5,0,1,0,0,1,0,0,0,0,1,9,0,12
74,13,648,225,423,3,420,1,419,155,95,94,44,17,3,0,0,0,1,0,0,2,1,1,0,3,0,3
75,13,637,252,385,1,384,5,379,108,90,118,23,17,10,0,0,0,0,1,2,0,0,0,0,3,0,7
76,13,576,189,387,0,387,2,385,148,91,59,46,24,6,0,0,0,0,0,0,0,0,0,0,2,0,9
77,13,611,183,428,1,427,10,417,136,101,80,55,20,10,0,0,0,0,0,0,0,1,0,0,4,1,9
78,13,548,161,387,1,386,2,384,151,91,70,39,19,3,1,0,1,0,0,0,1,0,1,0,2,1,4
79,14,531,167,364,0,364,9,355,171,80,33,46,9,7,1,0,0,0,0,1,0,0,1,0,2,0,4
80,14,537,147,390,2,388,5,383,156,89,48,53,9,9,1,0,0,1,0,2,0,1,0,0,4,0,10
81,14,519,186,333,0,333,0,333,98,89,78,37,16,8,0,0,0,0,0,0,0,0,0,0,3,1,3
82,14,510,193,317,0,317,0,317,85,83,68,33,23,6,2,1,0,0,0,0,0,2,0,0,4,0,10
83,14,950,371,579,4,575,9,566,162,143,142,56,39,7,0,0,0,1,1,1,0,0,1,3,7,0,3
84,14,976,379,597,4,593,3,590,143,189,149,50,34,13,0,0,0,0,1,0,0,0,0,0,5,3,3
85,14,901,307,594,2,592,3,589,138,200,143,51,37,10,0,0,0,0,2,0,0,0,0,0,6,0,2
86,14,548,174,374,0,374,3,371,112,99,76,44,20,10,0,0,0,0,0,1,0,0,0,0,6,0,3
87,14,525,188,337,3,334,4,330,114,70,67,47,10,14,0,0,0,0,2,0,0,0,1,1,2,0,2
88,14,522,208,314,4,310,5,305,92,87,67,23,24,4,0,0,0,0,0,0,0,0,0,1,3,0,4
89,14,573,206,367,4,363,4,359,87,117,79,41,16,6,0,0,0,0,0,1,0,0,1,1,5,0,5
90,14,641,206,435,2,433,4,429,130,106,100,53,23,11,0,0,0,0,0,2,0,0,1,0,1,1,1
91,14,541,158,383,4,379,2,377,113,100,81,42,20,5,1,0,0,0,0,0,0,0,0,0,6,1,8
92,14,544,178,366,0,366,2,364,165,98,44,32,13,4,0,0,0,0,0,1,0,0,0,0,1,0,6
93,14,520,162,358,1,357,2,355,149,79,41,51,11,9,0,0,0,0,0,0,0,0,0,0,3,0,12
94,14,910,260,650,7,643,3,640,295,148,83,81,13,8,0,1,0,0,0,0,0,1,0,1,2,0,7
95,14,805,238,567,3,564,4,560,215,124,93,68,27,9,0,1,0,0,0,0,0,0,1,4,8,0,10
96,14,566,148,418,6,412,8,404,121,109,73,49,27,8,0,1,0,0,0,0,0,0,1,2,1,0,12
97,14,587,206,381,1,380,3,377,132,106,63,43,16,3,0,0,0,0,0,1,0,0,0,0,5,0,8
98,15,617,192,425,1,424,7,417,161,89,77,46,21,8,0,0,0,0,1,3,0,1,0,1,5,0,4
99,15,810,269,541,7,534,3,531,129,166,119,53,41,12,0,0,0,1,0,0,0,0,1,1,2,1,5
100,15,569,177,392,1,391,1,390,102,108,101,42,22,8,0,0,0,0,0,0,0,0,0,0,5,0,2
101,15,1014,330,684,3,681,8,673,162,214,179,58,45,4,0,0,0,1,0,0,0,0,2,1,4,2,1
102,15,1002,340,662,4,658,6,652,149,196,182,56,39,14,0,0,0,0,0,0,0,1,0,1,6,0,8
103,15,1010,400,610,4,606,2,604,156,180,160,45,43,1,0,1,0,1,0,1,1,0,1,0,11,0,3
104,15,734,277,457,3,454,18,436,120,118,121,26,31,6,3,1,0,1,1,1,0,1,0,2,1,0,3
105,15,531,187,344,2,342,2,340,77,94,90,32,32,4,0,0,1,0,0,0,0,0,0,0,8,1,1
106,15,566,179,387,3,384,1,383,76,115,121,28,20,9,0,0,1,0,0,0,0,1,0,0,9,1,2
107,15,905,326,579,8,571,7,564,105,148,189,44,45,14,0,0,0,0,1,1,0,1,1,1,10,1,3
108,15,889,291,598,5,593,1,592,123,161,166,69,40,12,0,4,0,0,0,2,1,0,0,0,10,1,3
109,15,891,290,601,9,592,0,592,120,192,195,32,28,10,0,0,0,1,0,3,0,2,0,0,4,2,3
110,15,903,307,596,3,593,5,588,118,169,186,51,47,1,0,1,0,0,0,0,0,2,1,0,6,2,4
111,15,870,248,622,3,619,2,617,162,164,165,57,42,11,1,1,0,0,0,0,0,3,1,1,5,1,3
112,15,536,170,366,2,364,8,356,155,57,64,41,14,3,1,0,0,0,0,1,0,0,0,0,4,2,14
113,15,506,175,331,1,330,0,330,150,57,51,32,13,4,0,0,0,0,0,2,0,0,0,2,4,2,13
114,15,851,273,578,7,571,6,565,109,165,171,55,35,12,0,0,0,0,0,0,0,2,1,0,9,1,5
115,15,917,306,611,5,606,0,606,133,167,196,47,41,7,0,0,0,0,0,0,0,0,2,0,7,1,5
116,15,880,232,648,2,646,5,641,276,120,106,81,30,13,0,0,0,0,0,2,1,0,0,0,2,0,10
117,15,888,274,614,3,611,4,607,291,115,71,81,9,5,1,4,0,1,1,0,0,1,0,0,4,0,23
118,15,981,284,697,1,696,8,688,220,174,153,74,34,12,0,0,0,0,0,0,0,0,0,0,9,0,12
119,15,655,221,434,1,433,3,430,116,105,128,42,18,6,0,0,1,0,0,1,0,1,0,0,8,0,4
120,15,666,231,435,3,432,7,425,109,129,110,41,15,14,1,0,0,0,0,1,0,1,0,0,2,0,2
121,15,681,193,488,4,484,2,482,127,131,108,61,24,15,1,0,0,0,0,0,0,0,0,0,3,0,12
122,15,682,213,469,1,468,5,463,135,110,127,45,18,17,0,0,0,0,0,1,0,1,0,1,4,0,4
123,15,775,274,501,2,499,7,492,127,138,137,46,21,16,0,0,0,1,0,0,0,0,0,0,2,2,2
124,15,533,185,348,0,348,0,348,97,90,93,34,26,4,0,0,0,0,0,0,0,0,1,0,3,0,0
125,15,534,187,347,1,346,2,344,72,86,116,33,29,3,0,1,0,0,0,0,0,0,1,0,2,0,1
126,15,735,291,444,2,442,4,438,143,112,96,37,18,9,0,2,0,0,0,0,0,2,0,0,4,1,14
127,15,944,367,577,3,574,0,574,175,125,168,47,36,10,0,0,1,0,3,0,0,0,0,2,6,0,1
128,16,612,219,393,3,390,7,383,131,91,79,42,19,7,0,2,0,0,0,0,0,0,1,0,1,0,10
129,16,553,209,344,1,343,2,341,126,78,63,35,17,2,0,3,0,3,0,0,0,0,0,1,4,0,9
130,16,571,246,325,1,324,2,322,96,89,76,38,14,1,0,0,0,1,0,0,0,1,0,0,2,1,3
131,16,728,365,363,3,360,0,360,94,78,111,38,18,13,1,0,0,0,1,2,0,0,0,0,1,0,3
132,16,562,216,346,1,345,1,344,102,77,93,25,21,9,0,0,0,1,0,1,0,0,1,3,7,1,3
133,16,551,197,354,1,353,3,350,112,86,88,35,15,5,1,0,0,0,0,0,0,1,0,0,3,0,4
134,16,586,194,392,1,391,3,388,128,93,85,40,22,6,0,0,0,0,0,2,0,0,1,0,3,3,5
135,16,547,180,367,5,362,2,360,110,100,86,27,15,8,0,0,0,0,0,0,0,0,0,1,7,0,6
136,16,545,181,364,0,364,3,361,134,71,89,32,19,4,0,0,0,0,0,1,0,2,0,0,3,1,5
137,21,852,262,590,3,587,9,578,146,182,119,66,36,21,0,0,0,0,1,0,0,0,1,0,5,0,1
138,21,586,177,409,2,407,2,405,129,118,83,27,26,14,0,0,0,0,0,1,0,1,1,0,2,0,3
139,21,601,172,429,2,427,3,424,114,108,108,44,24,11,0,0,0,1,0,1,0,0,0,0,8,0,5
140,21,976,243,733,6,727,11,716,325,128,108,92,21,14,1,0,0,0,1,1,0,0,1,0,7,1,16
141,21,848,222,626,3,623,12,611,318,93,67,63,14,12,1,0,0,0,0,0,0,0,0,0,4,0,39
142,21,622,153,469,9,460,7,453,153,126,86,42,19,7,0,0,0,0,0,1,0,0,0,0,6,1,12
143,21,902,188,714,4,710,6,704,249,162,120,81,32,28,1,1,0,0,0,3,2,0,0,1,9,0,15
144,21,993,247,746,9,737,5,732,245,147,153,118,20,21,0,0,0,1,0,3,0,1,0,1,13,2,7
145,21,604,180,424,3,421,5,416,226,36,55,56,13,8,0,0,0,0,0,0,0,0,0,0,4,0,18
146,21,665,212,453,6,447,4,443,132,127,100,44,24,7,0,0,0,0,0,1,0,1,1,2,2,0,2
147,21,673,200,473,2,471,1,470,126,141,115,36,35,9,0,0,1,0,0,0,0,0,0,0,4,3,0
148,21,808,186,622,7,615,8,607,218,166,92,79,33,11,0,0,0,0,1,0,0,0,0,1,1,0,5
149,21,756,165,591,1,590,6,584,187,167,94,85,28,8,1,0,0,0,0,0,0,0,0,0,6,1,7
150,21,849,246,603,5,598,4,594,241,115,91,76,40,8,2,2,0,0,0,0,0,0,1,0,3,0,15
151,21,929,257,672,3,669,13,656,192,184,108,118,13,24,1,0,0,0,2,0,0,1,2,2,1,0,8
152,21,505,107,398,5,393,4,389,159,93,67,35,18,9,0,0,0,0,0,1,0,0,0,0,3,0,4
153,21,524,115,409,1,408,6,402,148,96,81,38,18,6,0,0,0,0,0,0,0,1,2,0,5,0,7
154,21,925,237,688,4,684,0,684,200,222,126,63,46,10,1,0,1,0,0,0,1,1,1,1,7,1,3
155,21,953,186,767,7,760,7,753,287,185,120,90,28,15,2,2,0,1,0,1,0,0,0,0,1,2,19
156,21,774,173,601,8,593,5,588,166,169,128,62,33,19,0,0,0,1,0,0,0,1,1,0,2,0,6
157,21,734,161,573,5,568,9,559,140,155,132,73,23,9,1,0,0,0,1,0,1,0,0,2,4,3,15
158,21,601,128,473,1,472,4,468,161,132,86,52,20,5,0,1,0,0,0,0,0,0,0,0,1,2,8
159,21,616,123,493,3,490,9,481,146,122,92,67,27,13,1,0,0,0,1,0,0,0,1,0,8,0,3
160,21,549,127,422,4,418,7,411,137,96,77,60,25,8,0,0,0,0,0,0,0,0,0,0,5,0,3
161,21,542,126,416,0,416,4,412,161,105,72,46,13,6,0,0,0,0,1,1,0,0,0,2,2,0,3
162,22,606,154,452,3,449,2,447,134,115,104,42,22,9,0,0,0,0,0,0,5,0,0,2,5,0,9
163,22,651,165,486,3,483,6,477,133,100,106,79,20,17,0,0,1,0,0,2,2,0,0,1,5,0,11
164,22,699,150,549,4,545,2,543,221,137,75,55,29,8,0,0,1,0,0,1,0,0,1,1,4,0,10
165,22,783,157,626,2,624,2,622,218,154,105,77,39,10,0,1,0,0,0,0,0,0,0,3,2,2,11
166,22,763,162,601,2,599,12,587,168,176,114,69,29,15,0,1,0,0,0,3,0,1,0,1,5,0,5
167,22,795,206,589,7,582,6,576,164,189,86,74,33,14,1,2,0,0,0,2,0,0,0,1,4,0,6
168,22,893,225,668,4,664,11,653,248,169,96,91,26,12,0,0,0,0,0,1,0,1,1,1,4,0,3
169,22,870,208,662,4,658,5,653,231,176,94,81,28,19,0,0,0,1,0,0,0,1,0,0,6,1,15
170,22,667,113,554,2,552,0,552,183,151,100,70,19,13,0,0,0,0,1,1,0,0,0,2,4,0,8
171,22,609,98,511,6,505,5,500,169,126,100,62,21,10,0,0,0,0,0,0,0,0,0,0,0,1,11
172,22,883,206,677,1,676,10,666,245,187,89,76,35,25,0,0,0,0,0,1,0,0,0,1,3,0,4
173,22,901,240,661,4,657,4,653,194,173,183,50,26,15,0,0,0,0,0,0,0,0,0,0,6,0,6
174,22,756,237,519,3,516,1,515,134,167,119,38,30,10,0,0,0,0,0,0,1,1,0,1,7,1,6
175,22,967,247,720,3,717,3,714,204,210,176,53,34,16,1,1,0,1,4,0,1,0,1,0,7,0,5
176,22,656,184,472,3,469,3,466,129,136,105,51,24,14,2,0,0,0,0,0,0,0,0,0,1,1,3
177,22,720,196,524,3,521,6,515,178,135,115,41,28,12,0,0,0,0,0,0,0,0,0,0,4,0,2
178,22,627,176,451,5,446,1,445,133,127,108,31,26,6,0,0,0,2,1,0,0,0,0,1,3,0,7
179,22,510,133,377,8,369,4,365,123,113,66,31,16,6,0,0,0,1,0,0,0,0,0,0,2,1,6
180,22,546,145,401,8,393,6,387,125,101,85,38,18,7,0,0,1,0,0,0,0,1,0,0,5,1,5
181,22,836,188,648,9,639,6,633,195,171,136,68,26,23,0,0,0,0,1,0,0,0,0,0,5,0,8
182,22,677,270,407,2,405,6,399,86,137,106,29,20,12,0,1,0,2,0,0,0,0,1,0,3,1,1
183,22,531,188,343,4,339,3,336,68,93,104,34,18,8,0,0,0,1,0,1,0,1,0,1,5,0,2
184,22,554,142,412,2,410,3,407,124,117,84,43,13,14,0,1,0,1,0,0,0,0,1,0,2,1,6
185,22,579,154,425,1,424,4,420,143,115,84,40,13,9,0,1,0,0,1,0,0,0,3,0,4,2,5
186,22,994,227,767,9,758,7,751,221,216,141,78,52,21,1,0,0,0,1,1,1,0,2,2,7,0,7
187,22,593,101,492,0,492,11,481,144,129,106,57,23,11,0,0,0,0,0,1,2,0,0,0,4,1,3
188,22,543,96,447,4,443,7,436,154,107,77,53,23,13,0,0,0,0,0,0,0,0,1,0,4,1,3
189,22,512,136,376,5,371,1,370,98,102,86,48,21,8,0,0,0,0,0,0,0,0,0,1,3,0,3
190,22,589,141,448,5,443,4,439,117,118,112,45,25,11,1,1,0,0,0,0,0,1,0,0,4,0,4
191,22,896,195,701,0,701,4,697,270,200,97,83,16,17,0,0,0,0,0,0,0,1,0,0,4,0,9
192,22,851,167,684,1,683,5,678,258,169,109,80,17,19,0,1,0,0,0,1,0,0,1,2,8,0,13
193,22,583,194,389,1,388,4,384,132,92,73,44,24,5,0,1,0,0,1,0,1,1,0,4,2,4,0
194,22,1005,264,741,9,732,6,726,258,192,147,67,19,23,1,0,0,1,0,2,1,1,1,1,2,0,10
195,22,792,148,644,2,642,9,633,212,187,122,68,26,8,1,0,0,0,1,0,0,0,0,2,2,2,2
196,22,854,172,682,6,676,5,671,221,191,146,59,29,7,0,0,0,0,0,1,0,0,0,0,5,2,10
197,22,775,142,633,5,628,6,622,225,170,98,75,20,15,0,0,0,0,0,0,0,0,0,1,3,1,14
198,22,721,137,584,7,577,4,573,199,170,74,76,20,17,0,0,0,0,1,0,0,0,0,1,5,0,10
199,22,644,126,518,2,516,4,512,198,128,59,85,13,17,0,0,0,1,0,2,0,0,0,0,3,0,6
200,22,690,150,540,3,537,8,529,168,150,89,77,20,13,0,0,0,0,0,0,1,1,0,0,5,0,5
201,22,783,175,608,5,603,9,594,222,155,87,71,25,21,0,0,0,0,1,0,0,0,0,0,6,0,6
202,22,554,128,426,4,422,6,416,148,108,69,59,19,9,0,0,0,0,0,0,0,0,0,1,1,0,2
203,22,592,135,457,2,455,5,450,158,125,75,52,21,8,0,0,1,0,0,0,0,0,1,1,3,0,5
204,23,567,142,425,1,424,4,420,134,97,108,33,27,6,0,0,0,0,1,0,2,2,0,1,4,0,5
205,23,496,139,357,1,356,5,351,111,77,70,57,16,10,0,1,0,0,0,1,0,1,0,2,3,0,2
206,23,562,186,376,6,370,3,367,106,114,92,36,0,10,0,1,0,0,0,0,0,0,0,0,4,0,4
207,23,691,176,515,3,512,12,500,191,133,89,50,19,8,0,1,0,0,0,0,0,1,0,1,6,0,1
208,23,773,230,543,4,539,4,535,193,141,102,49,26,8,2,0,0,0,0,0,0,1,1,0,2,1,9
209,23,796,202,594,7,587,8,579,203,154,103,58,38,7,0,0,0,0,0,0,0,0,0,1,7,2,6
210,23,1014,245,769,5,764,7,757,321,196,113,71,23,18,0,0,0,0,0,2,1,2,0,0,3,0,7
211,23,887,241,646,4,642,5,637,209,179,144,40,45,7,1,0,0,0,0,1,0,0,0,4,2,1,4
212,23,575,161,414,3,411,4,407,154,86,93,34,13,9,0,0,0,1,0,0,1,2,0,0,5,0,9
213,23,732,202,530,4,526,2,524,202,134,96,40,25,12,1,1,0,0,1,1,0,2,0,0,4,0,5
214,23,664,192,472,2,470,3,467,161,126,102,37,16,17,0,1,0,0,0,0,0,1,0,1,1,0,4
215,23,719,227,492,2,490,5,485,138,133,111,43,34,6,1,0,0,0,1,0,1,2,0,0,7,1,7
216,23,760,237,523,5,518,3,515,165,157,105,48,16,10,0,0,0,0,0,2,0,3,0,0,6,1,2
217,23,690,197,493,4,489,12,477,177,122,83,49,24,12,0,0,0,0,0,1,0,0,1,1,3,1,3
218,23,761,249,512,5,507,4,503,194,117,104,37,26,14,0,1,1,0,1,1,0,0,1,0,3,0,3
219,23,824,258,566,7,559,8,551,182,143,121,33,40,10,4,1,3,1,1,0,0,1,2,0,7,1,1
220,23,589,164,425,4,421,1,420,131,114,96,40,25,3,0,0,0,1,1,0,0,0,3,0,3,1,2
221,23,659,215,444,3,441,5,436,157,112,96,32,21,5,0,0,0,1,0,1,0,1,1,0,7,0,2
222,23,775,284,491,3,488,2,486,157,134,132,29,12,9,0,1,1,0,0,2,0,1,0,0,4,2,2
223,23,1002,406,596,3,593,3,590,132,168,193,45,28,12,0,2,0,0,0,1,0,0,0,0,5,1,3
224,23,536,225,311,2,309,1,308,62,106,90,21,15,5,0,0,1,0,0,1,1,1,0,0,3,1,1
225,23,525,241,284,6,278,2,276,69,90,74,17,19,3,0,1,0,0,0,0,0,0,0,0,2,0,1
226,24,838,294,544,3,541,3,538,146,169,116,49,30,9,0,0,0,0,0,2,1,2,0,1,4,3,6
227,24,639,131,508,3,505,5,500,162,126,79,85,24,15,0,0,0,0,1,0,0,2,0,1,2,0,3
228,24,654,147,507,3,504,2,502,137,151,93,73,33,12,0,0,0,0,0,0,0,0,0,0,0,0,3
229,24,597,145,452,7,445,7,438,85,161,90,45,40,12,1,0,0,0,0,0,0,0,0,0,4,0,0
230,24,630,154,476,1,475,2,473,77,166,129,47,40,5,1,1,0,0,1,0,0,0,0,1,4,0,1
231,24,965,241,724,5,719,12,707,189,158,158,136,24,27,1,0,0,0,0,0,1,0,0,1,6,0,6
232,24,957,249,708,1,707,12,695,166,167,138,149,38,19,0,0,0,2,0,1,0,0,0,1,7,0,7
233,24,1013,251,762,5,757,14,743,246,180,135,110,33,14,0,1,0,1,0,4,1,0,2,0,2,0,14
234,24,1009,193,816,3,813,9,804,215,214,141,172,35,17,0,0,0,0,1,0,0,0,1,0,5,1,2
235,24,646,160,486,7,479,7,472,125,144,85,65,24,16,0,1,0,0,0,0,0,1,1,1,2,2,5
236,24,696,168,528,5,523,10,513,157,135,85,76,25,19,0,0,0,1,0,0,0,0,0,2,4,0,9
237,24,774,191,583,3,580,10,570,170,126,79,140,16,24,1,0,0,0,0,1,0,0,0,0,2,0,11
238,24,796,222,574,3,571,5,566,188,129,80,133,14,10,0,0,0,0,0,1,0,0,0,0,2,0,9
239,24,902,200,702,11,691,5,686,200,184,133,109,29,15,0,0,0,0,0,2,0,0,0,0,6,0,8
240,24,897,204,693,7,686,9,677,172,169,134,129,32,18,0,0,0,0,0,4,0,0,1,0,8,1,9
241,24,501,100,401,2,399,5,394,121,118,53,68,16,11,0,1,0,0,1,0,0,0,0,0,3,1,1
242,24,572,114,458,4,454,3,451,146,111,57,94,0,10,0,0,0,0,1,23,0,0,1,0,2,0,6
243,25,572,193,379,4,375,4,371,125,113,61,31,14,9,0,0,0,0,0,0,1,0,1,2,2,2,10
244,25,614,203,411,5,406,2,404,121,128,84,31,18,9,0,0,0,0,0,1,0,0,2,0,5,0,5
245,25,732,167,565,5,560,5,555,201,145,107,49,31,10,0,0,0,0,1,0,0,0,0,0,0,1,10
246,25,673,177,496,4,492,6,486,168,125,101,43,21,16,0,0,0,0,0,0,0,1,0,0,3,1,7
247,25,500,107,393,5,388,2,386,78,114,86,66,21,7,1,0,0,0,0,0,0,0,2,1,2,3,5
248,25,555,114,441,1,440,4,436,114,106,95,66,27,11,0,0,0,0,0,0,0,0,0,0,6,0,11
249,25,700,164,536,7,529,6,523,189,141,69,76,20,5,0,0,0,0,0,1,0,0,0,0,9,1,12
250,25,664,165,499,3,496,2,494,165,133,84,66,20,10,0,0,0,0,0,1,0,2,0,2,3,0,8
251,25,901,316,585,6,579,8,571,181,144,130,53,31,19,0,0,0,0,0,2,0,0,0,1,4,1,5
252,25,938,237,701,5,696,3,693,278,164,126,64,31,14,0,1,0,1,0,0,0,0,1,0,4,1,8
253,25,808,241,567,2,565,0,565,213,151,89,52,30,15,0,2,0,0,0,4,0,0,0,0,4,0,5
254,25,532,193,339,0,339,0,339,96,95,74,33,21,5,0,1,0,0,0,0,0,2,0,1,4,0,7
255,25,536,196,340,1,339,1,338,123,79,77,31,14,8,0,0,0,0,1,0,0,1,0,0,2,0,2
256,25,607,220,387,6,381,0,381,135,103,75,28,20,10,0,1,0,0,0,1,0,1,1,0,4,0,2
257,25,556,205,351,1,350,7,343,123,85,66,35,15,6,1,0,0,0,0,1,0,1,1,0,4,0,5
258,25,566,184,382,0,382,4,378,119,112,74,38,17,9,0,0,0,0,0,0,0,0,0,0,4,0,5
259,25,991,284,707,5,702,3,699,264,172,132,84,23,8,0,0,0,1,0,0,0,2,1,0,2,0,10
260,25,645,205,440,3,437,9,428,152,80,98,54,20,8,0,0,0,0,0,0,0,0,1,0,5,2,8
261,25,772,259,513,5,508,4,504,132,134,119,41,51,7,0,0,0,2,0,0,0,4,1,1,7,0,5
262,25,625,188,437,5,432,4,428,152,97,100,47,14,11,1,0,0,0,0,0,0,0,0,0,3,1,2
263,25,593,185,408,2,406,4,402,125,104,79,50,23,13,0,0,0,0,0,0,0,0,1,1,0,0,6
264,25,591,117,474,1,473,7,466,120,133,90,79,18,16,1,0,0,0,0,0,0,1,0,2,0,0,6
265,25,726,138,588,0,588,5,583,164,159,92,111,27,13,0,0,0,0,1,1,1,1,0,1,2,0,10
266,25,655,141,514,4,510,2,508,157,154,87,74,15,15,0,0,0,0,0,0,0,0,0,0,1,0,5
267,25,888,226,662,5,657,7,650,174,148,127,127,41,13,1,0,0,1,0,0,0,0,1,3,6,1,7
268,25,776,219,557,5,552,8,544,174,138,64,118,21,15,1,0,1,0,0,0,0,0,0,1,3,2,6
269,25,822,196,626,4,622,6,616,189,152,88,127,17,26,0,0,0,0,0,0,0,1,1,2,6,1,6
270,25,865,170,695,2,693,2,691,191,165,146,116,35,18,0,1,0,1,1,1,0,0,0,0,7,0,9
271,25,822,201,621,4,617,1,616,167,188,119,93,29,15,0,0,0,0,0,0,0,0,0,0,2,1,2
272,26,658,177,481,8,473,3,470,185,114,77,42,25,10,0,0,0,0,0,0,0,0,0,3,6,0,8
273,26,706,215,491,1,490,4,486,185,126,88,56,20,6,0,0,0,0,0,0,0,0,0,0,3,0,2
274,26,621,198,423,4,419,1,418,133,98,93,53,18,12,0,1,0,0,0,0,0,0,1,1,5,0,3
275,26,600,228,372,3,369,3,366,114,103,76,35,24,9,0,0,0,1,0,0,0,0,0,0,2,0,2
276,26,941,288,653,9,644,11,633,198,183,106,90,29,12,0,0,0,0,0,0,0,0,0,2,3,2,8
277,26,1009,300,709,11,698,6,692,200,192,132,104,39,12,0,0,0,0,0,0,0,1,1,0,6,1,4
278,26,527,207,320,0,320,1,319,71,70,97,36,30,4,0,1,0,0,0,0,0,2,0,1,4,0,3
279,26,546,206,340,2,338,8,330,82,88,93,31,19,9,0,0,0,0,0,0,0,0,0,0,2,2,4
280,26,876,362,514,4,510,3,507,131,156,132,40,30,7,0,1,0,1,0,0,0,0,1,1,5,0,2
281,26,696,199,497,2,495,4,491,177,105,107,59,22,5,1,0,0,0,0,0,0,6,0,0,0,1,8
282,26,547,128,419,3,416,1,415,140,109,94,37,18,6,1,0,0,0,1,1,0,0,0,0,2,1,5
283,26,546,156,390,4,386,1,385,140,90,82,40,20,7,0,0,0,0,0,0,0,0,0,0,3,0,3
284,26,566,150,416,4,412,5,407,142,103,88,40,22,4,0,4,0,0,0,0,0,0,0,0,2,0,2
285,26,599,155,444,1,443,5,438,162,111,88,43,16,9,0,1,0,0,0,1,0,0,0,0,6,0,1
286,26,595,176,419,5,414,5,409,158,78,100,27,29,10,0,0,0,0,0,2,0,0,0,1,1,1,2
287,26,646,178,468,1,467,3,464,142,107,108,53,29,11,1,0,0,0,2,1,0,1,0,0,3,0,6
288,26,681,191,490,7,483,4,479,148,126,102,52,33,10,0,0,0,0,0,0,0,0,0,1,1,1,5
289,26,633,153,480,7,473,4,469,167,121,99,42,19,11,0,0,0,0,0,0,0,0,0,0,5,1,4
290,26,716,210,506,3,503,3,500,166,135,97,48,23,12,0,1,0,0,0,0,0,0,0,1,4,1,12
291,26,723,208,515,2,513,4,509,182,130,87,59,21,13,0,0,1,0,0,0,0,1,0,0,8,0,7
292,26,716,261,455,2,453,2,451,136,123,102,42,30,6,0,0,0,0,0,0,0,0,0,0,8,1,3
293,26,741,269,472,3,469,2,467,113,125,118,51,38,14,0,0,0,1,1,0,0,0,0,0,3,0,3
294,26,914,309,605,4,601,6,595,163,166,155,55,30,10,0,0,0,0,0,1,0,0,0,0,3,2,10
295,26,645,201,444,3,441,3,438,151,114,97,36,24,7,0,0,0,0,0,1,0,0,0,2,1,1,4
296,26,530,154,376,1,375,2,373,137,90,82,38,12,4,0,0,1,1,0,1,0,1,0,0,2,1,3
297,26,490,137,353,4,349,2,347,128,89,75,29,16,3,0,0,0,0,0,0,0,0,1,0,3,0,3
298,26,760,187,573,4,569,3,566,273,102,81,56,27,6,1,1,0,0,1,1,0,0,1,1,3,0,12
299,26,852,273,579,2,577,5,572,215,142,108,53,27,13,0,0,0,0,0,0,1,0,0,0,6,4,3
300,26,918,351,567,3,564,6,558,160,136,141,70,19,12,1,0,0,1,1,3,1,0,1,1,7,1,3
301,27,786,195,591,5,586,2,584,141,142,141,96,33,11,0,0,1,1,0,1,0,1,1,0,5,0,10
302,31,720,115,605,4,601,3,598,216,167,80,89,20,14,0,0,0,0,0,1,0,0,1,0,5,1,4
303,31,676,101,575,2,573,3,570,203,165,71,66,35,16,0,0,0,0,0,1,0,0,0,0,6,1,6
304,31,779,267,512,8,504,11,493,169,113,122,52,20,6,0,1,0,1,0,1,0,0,0,0,2,0,6
305,31,720,173,547,4,543,6,537,225,117,102,47,22,10,1,0,0,1,0,0,0,0,0,1,2,1,8
306,31,827,238,589,2,587,7,580,213,139,106,73,18,13,0,0,0,0,0,4,0,0,0,1,2,1,10
307,31,566,186,380,2,378,3,375,136,106,71,29,14,10,0,0,0,1,1,1,0,0,0,0,3,0,3
308,31,942,221,721,9,712,5,707,274,196,113,77,20,11,0,0,0,2,0,0,0,1,2,0,4,0,7
309,31,921,248,673,7,666,6,660,279,170,81,68,35,13,0,0,0,0,0,1,0,2,0,1,4,0,6
310,31,694,225,469,9,460,6,454,129,143,86,40,25,19,0,0,0,0,0,0,0,1,0,0,4,1,6
311,31,930,272,658,2,656,5,651,238,170,115,60,36,11,0,0,0,0,0,0,0,1,0,0,7,0,13
312,31,832,217,615,3,612,4,608,262,138,92,58,24,17,0,1,0,0,0,0,0,2,0,0,4,0,10
313,31,876,237,639,8,631,6,625,287,154,82,54,22,7,1,1,0,0,0,1,0,0,0,0,2,1,13
314,31,898,233,665,12,653,4,649,220,182,112,67,27,13,1,1,0,0,0,2,0,0,0,2,4,1,17
315,31,821,187,634,2,632,6,626,261,146,91,69,24,22,0,0,0,0,0,0,0,0,0,0,3,0,10
316,31,830,230,600,4,596,2,594,236,153,92,59,24,10,0,0,0,0,1,0,0,0,0,1,5,1,12
317,31,477,129,348,4,344,7,337,159,73,35,31,9,14,0,0,0,0,0,0,0,0,1,1,2,1,11
318,31,549,156,393,1,392,3,389,150,84,71,48,14,10,1,1,0,1,0,0,0,0,0,1,4,0,4
319,31,804,228,576,4,572,8,564,214,143,84,73,20,14,0,0,0,2,0,0,0,0,0,0,5,0,9
320,31,606,211,395,4,391,3,388,126,114,78,37,14,6,0,0,0,0,0,2,0,0,0,2,3,0,6
321,31,560,159,401,2,399,3,396,172,93,64,36,7,8,0,0,0,0,0,0,0,0,0,0,6,1,9
322,31,483,120,363,5,358,0,358,149,86,53,40,9,10,0,0,0,0,0,0,0,0,0,0,3,1,7
323,31,764,204,560,6,554,4,550,236,120,87,55,19,12,1,0,0,0,0,1,0,2,0,0,6,0,11
324,31,806,250,556,4,552,6,546,211,133,86,62,15,15,1,0,1,1,0,0,1,0,0,0,9,0,11
325,31,801,215,586,0,586,9,577,269,128,53,80,19,10,0,0,0,0,0,1,0,0,0,1,4,0,12
326,31,803,159,644,3,641,7,634,346,114,67,58,17,10,0,1,0,0,0,0,0,0,0,0,6,0,15
327,31,547,161,386,2,384,3,381,148,95,56,52,16,3,0,0,0,0,1,0,0,1,1,0,2,1,5
328,31,519,154,365,0,365,5,360,125,107,60,45,10,1,0,1,0,0,0,0,0,0,1,0,3,3,4
329,31,708,210,498,1,497,5,492,196,122,80,53,20,13,0,1,0,0,1,0,1,0,0,1,0,0,4
330,31,643,178,465,9,456,3,453,144,137,72,51,26,9,0,1,0,0,0,0,0,1,0,0,8,2,2
331,31,815,294,521,2,519,4,515,203,114,87,55,32,10,0,2,0,0,2,0,0,0,4,1,3,0,2
332,31,802,205,597,7,590,9,581,208,134,98,83,21,23,3,0,0,0,0,0,0,1,0,0,4,0,6
333,31,849,192,657,4,653,3,650,335,125,69,79,8,11,1,0,0,0,0,0,0,2,0,0,3,2,15
334,31,871,182,689,11,678,6,672,304,151,65,97,18,12,0,0,0,0,1,3,0,1,0,0,4,0,16
335,31,797,159,638,2,636,2,634,275,150,77,81,23,15,0,0,0,0,0,0,0,0,0,0,7,0,6
336,31,791,160,631,2,629,6,623,261,145,75,73,28,13,0,0,0,0,0,0,1,0,1,0,8,0,18
337,31,836,173,663,3,660,14,646,225,154,87,102,42,17,0,0,0,1,0,0,0,0,0,1,4,0,13
338,31,756,159,597,3,594,3,591,210,141,86,101,25,14,0,0,0,0,2,1,0,0,1,0,1,1,8
339,32,1005,243,762,2,760,8,752,244,207,121,96,38,17,1,0,0,0,0,0,0,0,0,2,8,0,18
340,32,783,168,615,7,608,26,582,187,149,106,89,24,11,0,1,0,0,0,0,0,1,0,1,5,0,8
341,32,893,239,654,7,647,10,637,206,152,134,95,27,11,0,0,1,0,0,1,0,0,0,0,2,0,8
342,32,726,204,522,7,515,4,511,179,144,80,60,33,4,2,0,0,0,0,0,0,0,1,2,4,1,1
343,32,672,172,500,4,496,6,490,177,130,84,57,26,6,1,0,0,0,0,0,0,0,0,0,4,2,3
344,32,1000,304,696,12,684,5,679,202,166,165,74,29,14,0,1,0,1,0,2,0,0,0,0,13,2,10
345,32,618,164,454,3,451,3,448,123,122,95,58,19,17,0,0,0,2,0,0,0,1,0,0,5,1,5
346,32,557,135,422,2,420,4,416,137,104,73,64,20,9,1,0,0,0,0,1,0,2,0,0,1,0,4
347,32,597,135,462,4,458,5,453,192,98,64,68,16,5,2,0,0,0,0,0,0,2,0,1,4,1,0
348,32,619,122,497,3,494,2,492,227,95,74,60,15,5,0,3,0,0,0,0,0,0,1,0,2,0,10
349,32,696,125,571,1,570,7,563,326,95,37,78,6,8,0,0,0,0,0,0,0,0,0,2,1,0,10
350,32,790,177,613,5,608,3,605,308,120,40,92,14,14,0,1,0,0,0,0,0,0,0,0,3,0,13
351,32,815,191,624,3,621,13,608,309,109,51,96,15,13,0,1,0,0,1,0,0,0,0,1,1,0,11
352,32,905,202,703,3,700,6,694,236,190,103,101,26,23,0,0,0,1,0,0,0,2,0,0,1,2,9
353,32,1000,203,797,3,794,7,787,253,232,116,110,33,27,0,0,0,1,0,0,0,1,1,0,5,1,7
354,32,708,196,512,2,510,6,504,133,101,140,70,29,9,0,0,1,0,0,0,0,1,1,4,6,0,9
355,32,711,199,512,4,508,2,506,153,114,124,69,24,11,0,0,0,1,0,1,0,1,0,0,7,0,1
356,32,532,155,377,3,374,0,374,131,97,63,53,5,12,0,1,0,0,0,0,0,2,0,0,2,0,8
357,32,562,191,371,5,366,7,359,116,94,61,49,9,10,0,0,0,0,0,0,0,1,1,1,5,0,12
358,33,934,242,692,3,689,10,679,332,128,89,80,18,15,0,0,0,0,0,0,0,0,1,1,2,0,13
359,33,907,225,682,3,679,6,673,299,148,86,79,32,12,0,2,0,0,0,1,0,0,0,0,2,1,11
360,33,619,157,462,4,458,3,455,189,115,56,57,20,5,0,0,0,0,0,0,0,1,0,0,4,0,8
361,33,693,190,503,6,497,9,488,198,118,68,57,17,15,0,0,1,0,0,0,2,0,0,0,4,0,8
362,33,619,124,495,4,491,4,487,202,119,67,59,15,10,0,0,0,0,0,0,1,0,0,0,3,1,10
363,33,574,116,458,4,454,6,448,194,99,53,61,19,4,0,0,0,0,0,0,0,0,0,1,7,1,9
364,33,926,192,734,4,730,6,724,326,149,88,90,27,16,0,1,0,1,0,0,1,0,0,0,5,1,19
365,33,768,133,635,3,632,11,621,294,125,66,88,17,4,0,0,0,0,0,0,0,1,1,1,3,0,21
366,33,602,90,512,1,511,3,508,251,87,41,73,7,7,0,0,0,0,0,1,1,1,0,3,2,1,33
367,33,571,107,464,3,461,9,452,217,95,41,48,9,12,0,1,0,0,1,0,0,0,0,0,4,1,23
368,33,919,198,721,3,718,8,710,383,104,59,101,17,21,0,1,0,0,0,0,0,0,1,1,3,0,19
369,33,716,135,581,3,578,8,570,273,136,51,69,12,12,0,0,0,0,0,1,0,0,0,0,3,0,13
370,33,644,124,520,0,520,6,514,237,110,42,85,18,5,0,0,0,1,0,0,0,0,0,0,1,0,15
371,33,972,199,773,3,770,10,760,340,175,78,76,29,29,0,1,0,0,2,2,0,0,3,0,3,0,22
372,33,948,270,678,5,673,9,664,287,137,104,89,24,9,0,1,0,0,1,0,0,0,1,0,6,0,5
373,33,893,232,661,5,656,11,645,282,158,72,74,21,14,0,0,0,0,0,0,0,0,1,0,4,2,17
374,33,913,189,724,0,724,5,719,312,175,112,72,19,13,0,2,0,0,0,0,1,0,0,1,3,0,9
375,33,742,201,541,4,537,2,535,292,108,45,63,10,5,0,0,0,0,0,1,0,1,0,0,2,0,8
376,33,636,187,449,3,446,6,440,245,72,55,37,14,8,0,0,0,1,0,0,0,0,0,0,4,1,3
377,33,623,193,430,6,424,2,422,200,66,54,48,13,6,0,1,2,0,1,2,2,0,0,0,9,2,16
378,33,542,95,447,2,445,4,441,206,94,46,55,14,9,0,0,0,0,0,0,1,0,0,2,5,0,9
379,33,487,93,394,3,391,1,390,199,83,37,43,14,5,0,0,0,0,0,0,0,1,0,0,3,0,5
380,33,753,155,598,0,598,4,594,303,127,34,89,12,12,0,0,0,0,1,0,0,0,0,0,7,0,9
381,33,712,133,579,4,575,4,571,276,105,70,77,11,17,0,0,0,1,0,0,1,0,0,0,1,0,12
382,33,540,114,426,4,422,6,416,240,69,38,39,12,8,0,0,0,0,0,1,0,0,0,0,1,0,8
383,33,508,95,413,6,407,4,403,241,66,24,42,11,8,1,0,0,0,0,0,0,0,0,0,2,0,8
384,33,670,107,563,3,560,5,555,303,103,33,84,6,4,0,0,0,0,1,3,0,0,0,1,7,0,10
385,34,938,279,659,7,652,6,646,267,132,88,94,18,19,0,0,0,1,1,2,1,1,1,1,3,0,17
386,34,711,194,517,2,515,4,511,231,121,79,41,19,5,1,0,0,0,0,0,0,0,1,1,0,0,12
387,34,800,224,576,4,572,1,571,259,124,76,63,20,12,1,0,0,0,0,0,0,0,0,1,2,0,13
388,34,551,148,403,2,401,4,397,167,67,54,63,19,7,0,0,0,0,0,1,0,2,0,1,4,0,12
389,34,585,154,431,3,428,2,426,158,96,66,70,11,7,0,0,0,0,0,0,0,0,1,0,6,0,11
390,34,917,245,672,8,664,2,662,284,130,97,98,24,9,0,1,0,1,1,0,0,1,3,1,6,0,6
391,34,746,207,539,1,538,7,531,176,125,89,76,30,14,1,0,1,0,0,0,0,0,0,1,6,2,10
392,34,565,150,415,2,413,4,409,174,79,73,43,19,9,0,0,0,0,1,0,0,0,0,0,1,1,9
393,34,515,174,341,3,338,6,332,134,77,60,40,6,1,0,1,0,0,1,0,0,0,0,1,3,0,8
394,34,545,123,422,2,420,4,416,212,82,43,29,20,9,0,0,0,0,1,1,0,1,0,0,6,0,12
395,34,541,143,398,1,397,5,392,186,87,48,40,14,4,0,0,0,0,0,0,0,0,0,1,2,1,9
396,34,751,257,494,2,492,5,487,163,122,102,58,22,9,0,2,0,0,0,0,0,0,0,3,2,0,4
397,34,899,220,679,6,673,8,665,244,137,105,94,41,14,0,3,0,0,0,0,0,0,0,1,4,0,22
398,34,849,210,639,6,633,7,626,291,123,84,69,15,18,0,2,0,0,0,2,0,1,0,2,3,0,16
399,34,979,311,668,7,661,7,654,283,165,87,63,18,12,1,0,1,0,0,4,1,0,0,2,8,0,9
400,34,884,253,631,4,627,3,624,281,142,73,75,11,12,0,0,0,0,0,2,2,1,0,1,5,0,19
401,34,560,162,398,6,392,3,389,152,94,64,45,19,6,0,1,0,0,0,0,0,0,0,0,2,0,6
402,34,702,200,502,6,496,3,493,175,121,74,66,23,7,4,1,0,1,0,1,0,0,2,2,8,0,8
403,34,534,144,390,2,388,1,387,179,79,52,41,8,9,0,0,0,0,0,0,2,0,0,0,4,0,13
404,34,609,201,408,0,408,7,401,206,78,48,46,9,5,0,1,0,0,0,0,0,0,0,0,2,0,6
405,34,787,217,570,0,570,2,568,293,91,53,102,12,4,0,0,0,0,2,3,0,0,0,1,1,0,6
406,34,579,161,418,0,418,6,412,219,67,44,47,13,5,1,1,0,1,0,0,1,1,0,1,2,0,9
407,34,689,201,488,2,486,3,483,229,82,60,62,15,10,0,0,0,0,0,0,0,0,0,0,7,0,18
408,34,948,227,721,0,721,5,716,349,125,81,102,24,13,0,0,0,0,1,2,0,0,1,0,5,0,13
409,35,703,239,464,1,463,9,454,267,56,44,61,6,6,0,1,0,0,0,0,0,0,0,1,2,0,10
410,35,600,166,434,5,429,4,425,267,53,20,59,3,6,0,0,0,0,0,0,0,0,0,1,1,0,15
411,35,548,138,410,3,407,1,406,220,75,36,52,8,5,2,0,1,0,1,0,0,0,0,1,0,1,4
412,35,563,157,406,1,405,2,403,232,88,23,40,8,3,0,0,0,0,0,0,0,0,0,0,3,0,6
413,35,690,184,506,2,504,4,500,223,90,66,49,30,5,0,4,0,0,0,1,2,0,0,1,4,2,23
414,35,642,173,469,2,467,2,465,225,80,56,62,13,9,1,1,0,0,0,1,1,0,0,0,3,0,13
415,35,975,253,722,3,719,5,714,403,107,64,91,12,6,0,0,0,0,0,0,0,0,0,1,3,0,27
416,35,967,243,724,4,720,8,712,442,78,40,81,14,6,0,6,0,0,2,0,0,1,1,1,0,0,40
417,36,705,159,546,2,544,1,543,289,115,32,68,7,13,0,0,0,0,0,0,0,1,0,0,4,0,14
418,36,643,150,493,2,491,5,486,299,62,38,53,11,7,1,0,0,0,1,0,0,1,0,0,1,0,12
419,36,558,112,446,0,446,4,442,267,50,29,64,11,5,0,0,0,0,1,0,0,0,0,0,1,0,14
420,36,635,158,477,3,474,7,467,274,63,24,63,10,11,0,2,0,0,0,1,0,0,0,0,3,0,16
421,36,539,156,383,1,382,3,379,188,61,46,53,18,3,0,0,0,0,0,0,0,0,0,0,3,0,7
422,36,527,170,357,2,355,7,348,169,65,35,52,10,6,1,0,0,0,0,0,0,0,0,1,1,0,8
423,36,665,156,509,6,503,7,496,258,88,39,68,17,10,0,2,0,0,0,0,0,0,0,1,3,2,8
424,36,728,177,551,3,548,5,543,270,111,44,79,12,7,0,0,0,0,0,2,0,0,0,0,5,0,13
425,36,747,144,603,2,601,4,597,420,70,19,64,3,8,0,0,0,1,0,0,0,0,0,0,1,0,11
426,36,705,124,581,8,573,6,567,395,54,24,68,4,10,2,0,0,0,0,0,0,0,1,0,1,0,8
427,36,602,133,469,0,469,7,462,276,80,23,53,8,5,0,2,0,0,0,0,0,0,0,2,1,0,12
428,36,561,111,450,3,447,6,441,267,65,22,64,5,5,0,0,0,0,0,1,0,1,0,0,0,0,11
429,36,610,122,488,2,486,5,481,225,93,44,83,10,8,1,0,0,0,0,1,0,0,0,0,1,1,14
430,36,574,119,455,6,449,4,445,215,79,50,62,11,12,0,0,0,0,1,1,0,1,0,1,1,0,11
431,36,701,141,560,3,557,4,553,298,88,46,69,11,19,0,1,0,0,0,0,0,1,0,0,3,0,17
432,36,816,215,601,5,596,3,593,246,127,80,89,20,14,1,0,0,0,1,0,1,0,0,0,3,0,11
433,36,646,120,526,2,524,11,513,239,101,62,68,12,15,0,1,0,0,0,0,0,1,1,0,4,0,9
434,36,723,134,589,5,584,1,583,284,111,58,76,13,16,0,2,0,0,1,0,0,0,0,0,5,0,17
435,36,543,167,376,0,376,2,374,170,70,49,48,7,11,0,3,1,0,0,0,0,0,0,0,2,0,13
436,41,694,235,459,1,458,4,454,275,57,27,63,8,8,0,0,0,0,2,0,0,1,0,1,2,0,10
437,41,802,240,562,1,561,3,558,369,62,19,61,9,5,0,0,0,0,1,0,0,0,1,2,1,0,28
438,41,613,177,436,2,434,11,423,269,63,14,49,5,7,0,0,0,0,1,0,0,0,0,1,1,0,13
439,41,697,187,510,5,505,8,497,349,43,10,55,7,11,0,1,0,0,1,1,0,0,0,0,0,0,19
440,41,645,195,450,2,448,4,444,302,32,19,59,6,10,0,0,0,0,1,0,0,0,0,0,1,0,14
441,41,735,228,507,0,507,5,502,311,72,28,57,9,3,0,0,1,0,0,0,0,0,0,1,0,0,20
442,41,978,295,683,1,682,6,676,440,84,40,75,7,7,0,3,0,0,0,0,0,0,0,1,1,0,18
443,41,839,256,583,9,574,10,564,333,73,23,85,9,8,0,1,0,0,0,3,0,0,0,5,5,0,19
444,41,751,165,586,1,585,1,584,433,36,17,67,1,3,1,2,0,0,1,0,0,0,0,2,0,0,21
445,41,736,166,570,2,568,4,564,411,46,17,60,2,5,0,1,0,0,0,3,0,0,0,2,0,0,17
446,41,564,153,411,5,406,3,403,252,28,24,46,9,7,0,0,0,0,6,0,0,1,0,1,0,0,29
447,41,560,156,404,2,402,6,396,243,53,22,51,4,5,0,2,0,0,0,0,0,1,0,2,1,0,12
448,41,565,141,424,1,423,3,420,249,61,24,67,6,3,0,1,0,0,0,0,0,0,0,1,3,0,5
449,41,966,256,710,4,706,5,701,459,85,31,77,11,11,0,0,0,0,1,0,0,0,1,2,1,0,22
450,41,739,208,531,6,525,2,523,330,59,29,65,13,7,0,0,0,1,0,0,1,0,0,0,2,0,16
451,41,906,258,648,1,647,6,641,400,96,36,82,0,3,0,0,0,0,0,4,0,0,0,0,0,2,18
452,42,537,131,406,2,404,0,404,234,58,25,59,8,5,0,1,0,0,0,0,0,0,0,1,2,2,9
453,42,475,134,341,1,340,5,335,175,61,19,50,14,3,0,0,0,1,0,1,0,0,0,0,4,0,7
454,42,498,151,347,0,347,2,345,201,42,29,44,7,8,0,0,0,0,1,0,0,0,0,0,0,0,13
455,42,530,164,366,3,363,0,363,199,49,25,58,9,6,0,0,0,0,0,0,0,0,0,0,6,0,11
456,42,496,138,358,2,356,6,350,181,60,30,48,12,8,0,0,0,0,0,0,0,0,0,0,3,0,8
457,42,516,147,369,2,367,0,367,207,72,21,42,9,3,2,0,0,0,0,1,0,0,0,0,2,0,8
458,42,513,165,348,1,347,0,347,176,68,51,27,8,6,1,0,0,0,1,0,0,0,0,0,3,0,6
459,42,493,108,385,1,384,8,376,183,60,44,60,9,7,0,1,0,0,1,1,0,0,0,0,1,0,9
460,42,543,163,380,4,376,3,373,199,77,23,49,5,5,0,0,0,0,0,0,0,1,0,1,4,2,7
461,42,558,164,394,5,389,6,383,203,63,48,45,6,3,0,0,0,0,0,0,0,0,0,1,2,0,12
462,42,691,215,476,8,468,4,464,219,86,48,67,13,11,0,1,0,0,0,1,0,0,0,0,4,1,13
463,42,674,234,440,2,438,9,429,220,77,44,49,13,10,1,0,0,1,0,0,0,0,1,0,5,0,8
464,42,979,347,632,3,629,10,619,279,149,57,76,24,10,0,1,0,2,0,1,0,0,0,0,5,2,13
465,42,729,233,496,5,491,5,486,282,72,42,60,7,4,0,1,0,0,1,0,0,0,1,3,0,1,12
466,42,655,191,464,2,462,5,457,224,79,39,85,7,5,0,0,0,0,0,1,0,2,0,0,4,0,11
467,42,581,169,412,1,411,1,410,196,89,38,55,14,5,0,0,0,0,0,0,0,2,0,0,4,1,6
468,42,535,159,376,2,374,2,372,149,76,34,68,14,9,0,1,0,0,1,2,0,1,0,1,4,1,11
469,42,555,184,371,2,369,6,363,176,77,32,51,12,5,0,0,0,0,0,0,0,2,0,0,2,0,6
470,42,516,203,313,2,311,1,310,134,69,35,41,11,5,2,0,0,0,0,0,0,3,0,0,3,0,7
471,42,550,157,393,1,392,4,388,210,60,36,55,9,8,0,0,0,0,0,0,0,0,0,0,3,0,7
472,42,548,141,407,0,407,5,402,224,83,19,55,7,6,0,0,0,0,0,0,0,0,0,0,0,0,8
473,42,515,143,372,4,368,5,363,213,55,22,45,8,5,0,0,0,3,1,0,0,0,0,0,2,0,9
474,42,544,148,396,0,396,3,393,240,48,37,41,12,3,1,0,0,0,0,0,0,0,0,0,1,0,10
475,42,640,188,452,0,452,9,443,265,64,30,59,7,3,0,0,0,0,0,0,0,0,0,1,0,0,14
476,42,644,219,425,0,425,12,413,178,102,50,51,14,4,0,0,0,0,1,0,0,0,0,2,2,0,9
477,42,888,262,626,5,621,8,613,296,118,68,80,14,4,0,1,0,0,0,0,0,0,0,1,4,0,27
478,42,648,201,447,3,444,7,437,229,86,38,52,13,3,0,0,0,0,1,0,0,1,0,0,3,0,11
479,42,611,206,405,1,404,4,400,208,80,43,36,14,11,0,0,0,0,0,1,0,0,0,0,3,0,4
480,42,547,170,377,4,373,1,372,170,81,45,52,8,8,0,0,0,0,0,0,0,0,0,0,2,2,4
481,42,565,189,376,1,375,2,373,172,71,43,52,13,10,0,0,0,0,0,0,1,2,0,0,0,0,9
482,42,663,191,472,1,471,4,467,251,70,41,69,10,5,0,0,0,0,0,0,0,0,0,0,3,0,18
483,42,645,176,469,2,467,3,464,203,113,57,54,8,10,0,0,1,0,0,0,0,0,0,1,4,1,12
484,42,844,282,562,3,559,1,558,263,122,61,62,19,15,0,0,0,0,0,0,0,0,0,0,3,1,12
485,42,657,203,454,4,450,3,447,236,79,45,51,6,3,0,0,0,1,0,0,0,0,0,0,11,0,15
486,42,653,191,462,1,461,6,455,231,88,37,57,11,8,0,0,0,0,0,1,0,2,0,1,4,0,15
487,42,782,251,531,7,524,4,520,257,109,67,49,13,10,0,1,0,0,2,0,2,0,0,0,1,0,9
488,42,520,112,408,4,404,2,402,245,44,33,49,7,6,0,0,0,0,0,0,0,0,0,0,4,0,14
489,42,564,151,413,3,410,2,408,261,55,27,44,4,6,0,0,0,0,0,0,0,1,0,0,2,0,8
490,43,545,134,411,1,410,9,401,185,83,50,46,19,6,0,0,0,0,0,0,0,1,1,0,2,1,7
491,43,550,141,409,1,408,3,405,156,83,81,55,13,7,1,0,0,0,1,0,0,0,0,0,2,0,6
492,43,533,145,388,6,382,5,377,160,88,43,50,14,8,0,0,0,0,0,0,0,0,0,0,4,0,10
493,43,574,162,412,6,406,3,403,155,126,53,38,11,6,0,2,0,1,0,0,0,0,0,1,3,0,7
494,43,597,162,435,2,433,2,431,150,111,77,62,14,6,0,0,0,1,0,2,0,1,0,0,4,0,3
495,43,557,130,427,4,423,4,419,165,110,62,42,17,11,0,1,0,0,0,0,0,0,1,0,7,0,3
496,43,573,146,427,3,424,1,423,192,87,54,56,11,6,0,1,0,0,0,0,1,0,0,0,4,0,11
497,43,967,238,729,8,721,7,714,281,176,96,108,14,20,1,0,0,0,0,0,0,2,0,1,4,1,10
498,43,758,244,514,2,512,2,510,221,146,49,66,16,7,0,0,0,0,0,0,0,1,0,0,1,0,3
499,43,547,186,361,0,361,3,358,147,95,50,42,10,4,0,0,0,0,0,0,0,1,0,0,4,0,5
500,43,541,189,352,3,349,5,344,142,81,47,38,11,7,0,1,0,1,1,1,0,1,0,1,4,2,6
501,43,518,166,352,2,350,6,344,100,107,62,47,14,4,0,0,0,0,0,0,0,1,0,2,3,0,4
502,43,981,284,697,6,691,9,682,266,172,103,80,27,16,0,1,0,0,1,2,0,1,0,0,5,2,6
503,43,857,240,617,5,612,3,609,247,118,95,86,21,15,0,5,0,0,0,1,0,0,0,4,6,0,11
504,43,933,268,665,20,645,6,639,249,166,91,70,24,14,0,0,0,0,0,1,0,0,0,3,8,2,11
505,43,512,146,366,9,357,0,357,180,57,39,46,14,5,0,0,0,1,0,1,0,1,0,0,2,1,10
506,43,525,133,392,1,391,8,383,179,85,45,50,11,5,0,0,0,0,0,0,0,0,0,0,1,0,7
507,43,712,198,514,4,510,2,508,230,106,67,65,23,6,1,0,0,0,0,0,0,1,0,0,3,1,5
508,43,627,163,464,3,461,6,455,196,112,48,55,16,12,0,0,0,0,2,0,0,0,0,0,4,1,9
509,43,589,146,443,1,442,2,440,216,90,46,48,15,11,0,0,0,0,0,5,0,0,0,0,1,1,7
510,43,574,177,397,2,395,3,392,198,81,39,38,14,10,0,0,0,0,0,1,0,0,0,1,0,1,9
511,43,901,253,648,8,640,7,633,268,132,92,88,23,11,0,1,0,0,1,0,0,0,1,0,3,0,13
512,43,1006,280,726,2,724,10,714,301,144,109,99,19,21,0,1,0,0,1,0,0,0,0,1,10,0,8
513,43,554,172,382,0,382,1,381,164,103,30,49,16,5,0,0,0,0,0,0,0,0,1,0,6,1,6
514,43,531,172,359,3,356,5,351,138,75,54,56,6,6,0,1,0,1,1,0,2,0,0,1,5,0,5
515,44,552,143,409,7,402,1,401,220,74,32,44,7,7,0,0,0,0,0,0,0,0,0,1,1,0,15
516,44,539,148,391,5,386,0,386,190,69,44,47,11,4,0,2,0,0,1,0,0,0,0,0,1,0,17
517,44,984,273,711,4,707,5,702,324,116,86,95,32,17,0,1,0,0,3,1,2,0,0,2,2,0,21
518,44,639,180,459,2,457,4,453,171,110,58,65,15,13,0,1,0,0,0,0,0,1,0,0,2,0,17
519,44,588,197,391,1,390,4,386,138,92,70,60,11,6,0,0,0,0,1,0,0,0,1,0,1,0,6
520,44,829,207,622,4,618,5,613,303,117,63,78,10,19,0,0,0,0,1,0,0,0,0,1,5,0,16
521,44,648,177,471,0,471,7,464,212,89,49,63,20,7,2,0,0,1,0,0,0,1,0,0,5,1,14
522,44,654,187,467,2,465,6,459,205,89,50,65,7,11,1,1,0,1,0,1,0,0,0,0,7,1,20
523,44,872,244,628,7,621,5,616,284,112,93,74,22,14,0,1,0,0,0,1,0,1,0,0,2,0,12
524,44,815,230,585,4,581,1,580,258,124,88,60,10,7,0,0,0,0,0,0,0,0,0,2,3,0,28
525,44,594,160,434,2,432,5,427,174,99,52,53,20,12,0,0,0,0,1,0,0,0,0,0,7,0,9
526,44,602,169,433,4,429,0,429,181,97,55,50,17,6,0,0,0,0,0,0,0,0,0,1,4,1,17
527,44,935,265,670,8,662,6,656,259,176,101,71,19,9,0,0,0,1,0,0,0,2,0,0,6,0,12
528,44,957,298,659,4,655,7,648,243,149,107,90,23,16,0,1,0,1,0,0,0,1,0,0,1,0,16
529,44,563,132,431,3,428,4,424,207,99,52,41,5,4,0,0,0,0,2,0,0,0,0,1,5,0,8
530,44,560,131,429,4,425,2,423,237,61,32,56,7,5,1,3,0,0,1,0,0,0,1,0,3,1,15
531,44,593,137,456,1,455,2,453,253,92,28,52,5,7,1,1,0,0,1,0,0,0,0,1,0,1,11
532,44,924,202,722,2,720,9,711,330,144,72,83,30,16,0,1,0,0,0,0,2,0,1,2,5,0,25
533,44,766,176,590,3,587,3,584,362,83,41,65,8,7,1,0,1,0,0,2,0,0,0,1,3,0,10
534,44,769,173,596,1,595,9,586,359,66,34,74,5,9,1,2,0,0,0,0,0,0,0,0,2,1,33
535,44,894,190,704,5,699,4,695,460,66,26,83,4,16,0,1,0,0,0,0,1,0,0,0,4,0,34
536,44,575,133,442,10,432,5,427,255,48,21,58,5,10,0,0,0,0,0,0,0,2,0,0,1,0,27
537,44,927,202,725,2,723,12,711,406,87,37,107,10,21,1,2,0,0,0,0,0,0,0,0,6,0,34
538,44,617,123,494,4,490,2,488,318,61,22,44,5,2,0,1,0,1,0,0,0,1,0,0,3,0,30
539,44,902,223,679,4,675,2,673,412,70,29,94,4,10,1,2,0,0,0,0,0,1,0,0,9,1,40
540,44,690,167,523,3,520,3,517,285,95,55,37,7,6,0,0,0,0,0,0,0,0,0,1,1,1,29
541,44,590,145,445,0,445,6,439,213,87,46,48,11,9,0,0,0,0,0,0,1,3,1,1,3,1,15
542,44,684,173,511,5,506,5,501,274,78,36,68,12,2,0,1,0,0,0,1,0,0,0,0,7,0,22
543,44,768,192,576,4,572,13,559,217,122,80,79,27,23,0,0,0,0,0,0,1,0,0,1,4,0,5
544,44,698,196,502,2,500,11,489,193,110,69,64,26,14,1,0,0,0,0,0,0,1,0,0,3,0,8
545,44,602,143,459,2,457,4,453,197,88,66,65,18,8,1,0,0,0,0,1,0,0,0,0,2,0,7
546,44,716,195,521,2,519,7,512,233,107,62,62,16,15,0,0,1,0,0,0,0,0,0,0,2,0,14
547,44,679,165,514,5,509,4,505,210,115,67,72,15,12,0,0,0,0,0,0,0,0,1,0,5,3,5
548,44,1009,288,721,3,718,5,713,306,142,86,104,33,15,0,1,0,0,2,0,3,1,0,1,5,1,13
549,44,877,244,633,9,624,4,620,260,123,84,84,27,16,0,2,0,0,2,0,0,0,0,0,5,1,16
550,44,770,232,538,3,535,6,529,244,127,60,56,13,11,0,1,0,0,1,0,0,0,0,0,4,12,0
551,44,804,248,556,0,556,5,551,257,129,58,61,20,10,0,0,0,0,0,0,0,0,0,0,5,0,11
552,44,589,190,399,2,397,4,393,142,114,59,40,22,8,0,0,0,0,0,1,0,0,0,1,1,1,4
553,44,954,293,661,1,660,6,654,261,126,114,82,28,11,2,0,0,0,0,1,0,1,0,0,15,0,13
554,44,568,189,379,1,378,4,374,124,82,80,45,23,7,0,0,0,0,0,0,0,0,1,2,4,0,6
555,44,539,178,361,1,360,3,357,141,75,70,40,16,4,0,1,0,0,0,1,0,0,1,0,2,0,6
556,44,770,203,567,2,565,8,557,199,152,83,72,13,12,1,3,0,0,0,2,0,0,0,0,7,0,13
557,44,809,283,526,3,523,1,522,192,120,93,69,26,9,0,0,0,0,2,1,0,0,0,0,5,0,5
558,44,568,134,434,1,433,4,429,214,82,51,47,13,9,0,0,0,1,0,0,0,0,0,1,4,0,7
559,44,538,115,423,3,420,1,419,232,71,35,42,8,11,0,3,0,2,0,1,0,0,0,1,5,0,8
560,45,522,186,336,2,334,3,331,169,68,38,32,10,4,0,0,0,0,0,0,0,0,0,0,2,0,8
561,45,560,143,417,5,412,3,409,238,59,37,41,9,7,1,0,0,0,0,0,0,1,0,1,3,0,12
562,45,733,201,532,5,527,3,524,316,67,33,74,7,6,0,0,0,0,0,1,0,1,0,0,1,1,17
563,45,531,120,411,1,410,0,410,254,52,29,50,7,4,1,0,0,0,0,0,1,0,0,0,1,0,11
564,45,529,130,399,6,393,3,390,226,48,24,55,10,2,0,0,0,0,0,1,0,0,0,0,3,1,20
565,45,866,268,598,3,595,9,586,330,91,68,54,12,9,0,1,0,0,0,2,0,0,0,0,9,0,10
566,45,636,155,481,5,476,4,472,293,68,39,43,7,4,0,0,0,0,0,0,0,0,0,0,3,0,15
567,45,684,262,422,4,418,3,415,189,92,42,66,7,10,1,0,0,0,0,0,0,0,0,0,3,0,5
568,45,855,303,552,3,549,3,546,283,101,58,67,12,6,0,1,0,0,0,3,0,0,0,0,4,0,11
569,45,931,256,675,10,665,9,656,306,129,61,93,20,14,0,0,0,0,3,0,1,0,0,0,6,0,23
570,45,880,282,598,10,588,4,584,299,112,78,56,22,5,0,1,0,0,0,0,0,1,0,0,5,0,5
571,45,886,235,651,3,648,2,646,334,100,60,77,18,16,1,1,0,0,1,0,0,0,0,3,5,0,30
572,45,805,273,532,2,530,4,526,239,117,57,72,0,16,0,0,0,0,1,12,0,0,0,0,4,1,7
573,45,496,129,367,0,367,0,367,207,63,27,34,8,4,0,0,0,0,0,1,0,0,2,2,1,0,18
574,45,706,187,519,2,517,5,512,262,87,64,72,8,5,0,0,0,0,0,0,0,0,0,0,2,0,12
575,45,593,146,447,1,446,2,444,232,68,34,76,14,8,0,1,0,0,1,0,0,0,0,1,0,0,9
576,45,662,205,457,6,451,6,445,235,76,31,60,14,6,1,1,0,0,0,0,0,2,0,1,4,0,14
577,45,859,243,616,3,613,7,606,333,102,72,58,16,4,0,0,0,0,0,0,0,0,0,2,6,0,13
578,45,710,180,530,3,527,9,518,314,68,39,57,15,4,0,0,0,0,0,0,0,0,1,0,3,0,17
579,45,713,189,524,3,521,5,516,276,87,37,68,13,4,0,1,0,2,0,0,0,0,0,1,5,0,22
580,45,947,259,688,2,686,12,674,396,84,41,92,20,12,1,0,0,0,0,0,0,0,0,0,5,1,22
581,45,832,240,592,1,591,6,585,346,99,37,62,9,8,0,0,0,0,0,1,0,1,0,0,2,0,20
582,46,522,110,412,5,407,3,404,305,22,17,41,0,1,0,1,0,0,0,0,0,0,0,0,0,0,17
583,46,576,130,446,2,444,8,436,314,29,20,45,4,0,0,1,0,0,1,0,0,0,0,0,0,0,22
584,46,734,185,549,0,549,7,542,437,34,11,26,2,4,0,1,0,0,1,0,1,0,0,1,0,0,24
585,46,746,164,582,2,580,4,576,437,42,13,48,1,6,0,3,0,0,0,0,0,0,0,1,1,0,24
586,46,657,196,461,2,459,10,449,290,53,26,53,1,4,0,1,0,0,0,0,0,0,0,1,0,0,20
587,46,654,193,461,2,459,0,459,322,43,17,52,4,4,0,1,1,1,0,0,0,0,0,0,2,0,12
588,46,596,179,417,1,416,2,414,303,33,13,42,1,6,0,0,0,0,0,0,1,0,0,1,3,0,11
589,46,524,128,396,4,392,6,386,264,37,19,41,2,4,0,4,0,0,0,0,0,0,0,1,0,0,14
590,46,576,156,420,5,415,5,410,316,32,9,27,1,3,0,1,0,0,0,0,0,1,0,0,4,0,16
591,46,760,181,579,2,577,5,572,398,40,21,84,5,6,1,1,0,0,0,0,0,0,0,0,2,0,14
592,46,912,203,709,1,708,5,703,496,55,24,78,4,6,0,3,0,0,3,0,0,1,0,2,2,1,28
593,46,523,142,381,0,381,6,375,230,57,18,44,6,3,1,0,1,0,0,0,0,0,1,1,0,0,13
594,46,590,160,430,2,428,6,422,265,51,21,48,8,6,0,2,0,0,1,0,0,0,0,0,0,0,20
595,46,681,244,437,6,431,5,426,245,59,32,53,9,5,0,0,1,0,1,0,1,0,2,0,2,0,16
596,46,589,125,464,0,464,4,460,321,34,20,47,5,5,0,1,0,0,0,0,0,1,0,1,4,0,21
597,46,538,125,413,2,411,3,408,269,36,22,49,5,3,0,0,0,1,0,0,0,1,0,0,3,0,19
598,46,748,222,526,2,524,2,522,339,69,22,48,9,5,1,1,0,1,0,0,0,0,0,0,3,0,24
599,46,707,262,445,0,445,0,445,262,71,22,58,12,5,0,2,0,0,0,0,0,1,0,0,1,0,11
600,46,559,180,379,1,378,7,371,223,55,30,37,6,7,0,4,0,0,0,1,0,0,0,1,1,0,6
601,46,586,161,425,2,423,4,419,298,39,16,46,4,1,0,2,0,0,1,0,0,0,0,1,0,0,11
602,51,871,180,691,6,685,14,671,552,40,13,47,3,0,0,0,0,0,0,0,0,0,0,0,2,0,14
603,51,611,190,421,5,416,4,412,307,28,9,45,7,4,0,0,0,0,0,0,0,0,0,0,2,0,10
604,51,591,150,441,1,440,3,437,320,44,15,45,3,1,0,0,0,0,0,1,0,1,0,0,0,0,7
605,51,734,195,539,2,537,3,534,384,54,11,55,2,0,0,3,0,0,0,0,0,0,2,1,0,0,22
606,51,712,193,519,0,519,6,513,370,41,20,58,6,3,0,2,0,0,0,0,0,0,0,0,2,0,11
607,51,548,123,425,0,425,5,420,306,36,10,49,3,4,0,0,0,0,0,0,0,0,0,0,1,0,11
608,51,526,136,390,1,389,6,383,306,21,7,35,0,1,0,0,0,0,0,0,1,0,0,1,2,0,9
609,51,542,147,395,0,395,7,388,266,40,14,42,2,5,0,1,0,0,0,0,0,0,0,1,1,0,16
610,51,523,120,403,1,402,4,398,276,34,14,55,1,6,0,0,0,0,0,0,0,0,0,0,0,0,12
611,51,959,234,725,3,722,3,719,532,66,13,71,3,6,0,1,0,0,0,1,0,0,0,1,2,0,23
612,51,708,150,558,4,554,11,543,355,64,20,68,5,8,1,1,0,0,0,1,0,0,0,0,1,0,19
613,51,746,179,567,3,564,5,559,357,71,24,68,6,11,0,0,0,0,1,0,0,0,0,0,1,0,20
614,51,564,139,425,0,425,2,423,320,30,12,44,5,2,0,0,1,0,0,0,0,0,0,0,0,0,9
615,51,532,136,396,0,396,4,392,292,32,10,36,0,3,0,1,0,0,0,2,0,0,0,0,5,0,11
616,51,881,253,628,5,623,8,615,382,71,24,94,12,8,1,0,1,0,0,0,0,1,0,0,0,0,21
617,51,660,193,467,3,464,11,453,246,71,35,71,3,10,0,0,0,0,0,0,0,0,0,0,0,0,17
618,51,601,166,435,1,434,9,425,221,71,40,52,11,4,0,0,0,2,0,2,0,0,0,2,5,0,15
619,51,834,222,612,1,611,5,606,336,111,45,60,22,10,0,0,0,0,1,1,0,0,0,0,3,0,17
620,51,655,181,474,2,472,1,471,274,72,35,57,13,6,0,0,0,0,0,0,0,0,0,1,2,0,11
621,52,851,238,613,2,611,6,605,251,134,87,80,21,9,0,0,0,0,0,1,0,0,0,0,6,1,15
622,52,792,219,573,4,569,9,560,251,111,51,90,24,14,1,2,0,0,0,0,1,0,0,1,1,1,12
623,52,645,193,452,4,448,4,444,190,102,67,43,20,10,0,0,1,1,0,0,0,0,0,1,1,0,8
624,52,527,145,382,7,375,2,373,148,93,51,36,19,14,0,1,0,1,0,3,0,0,0,0,3,0,4
625,52,552,145,407,6,401,2,399,163,108,59,40,12,13,0,0,0,0,0,0,0,0,0,0,0,0,4
626,52,493,143,350,4,346,2,344,144,67,54,51,11,6,1,0,0,0,0,1,0,0,0,1,4,1,3
627,52,536,160,376,1,375,2,373,153,90,63,48,9,3,1,0,0,0,0,2,0,0,0,0,3,0,1
628,52,703,212,491,5,486,7,479,242,84,67,55,9,4,0,0,0,0,1,0,0,1,0,1,4,2,9
629,52,951,277,674,6,668,10,658,245,148,88,102,24,23,0,0,0,0,0,0,0,1,0,0,7,0,20
630,52,622,225,397,6,391,1,390,131,104,64,52,20,7,0,0,0,0,0,0,0,0,0,1,8,0,3
631,52,570,165,405,2,403,1,402,159,99,57,53,7,7,0,2,0,0,0,0,0,1,0,2,12,0,3
632,52,564,185,379,3,376,1,375,143,100,62,37,20,7,0,1,0,0,0,0,0,1,0,0,1,0,3
633,52,560,157,403,1,402,2,400,176,88,50,51,12,4,0,0,0,0,0,0,0,0,0,1,3,0,15
634,52,562,130,432,2,430,2,428,207,79,36,67,10,9,1,2,0,0,1,0,0,1,0,0,3,0,12
635,52,748,226,522,3,519,9,510,254,140,40,47,12,7,0,0,0,0,0,0,0,0,3,1,1,0,5
636,52,898,267,631,2,629,8,621,281,128,74,83,13,13,1,2,0,0,1,0,0,1,1,1,10,2,10
637,52,656,191,465,2,463,4,459,192,115,55,56,21,8,0,0,0,0,0,0,0,0,0,0,6,0,6
638,52,689,195,494,5,489,7,482,214,114,57,57,15,7,0,0,2,1,0,0,0,1,0,0,5,0,9
639,52,652,181,471,2,469,6,463,200,105,57,63,14,6,0,1,0,0,0,0,0,1,0,0,6,0,10
640,52,695,181,514,2,512,2,510,230,103,68,61,22,6,0,0,0,1,0,0,0,0,3,2,4,0,10
641,52,796,219,577,6,571,8,563,206,143,86,78,19,15,0,1,0,0,1,1,0,1,0,1,8,0,3
642,52,729,219,510,1,509,2,507,184,128,77,71,23,8,1,1,0,0,0,0,0,1,0,1,3,1,8
643,52,639,198,441,2,439,3,436,148,106,91,52,15,11,0,0,0,0,0,0,1,0,1,0,5,2,4
644,52,676,175,501,4,497,5,492,142,131,107,69,21,5,0,0,0,0,2,0,0,0,0,0,5,0,10
645,52,980,292,688,6,682,13,669,212,172,127,70,52,16,0,0,0,0,0,1,0,0,0,1,6,0,12
646,52,789,246,543,1,542,4,538,242,97,69,79,23,10,0,0,0,0,0,0,0,0,0,1,3,0,14
647,52,529,152,377,4,373,3,370,137,82,62,49,15,9,0,0,1,0,0,0,0,2,0,0,1,3,9
648,52,557,172,385,2,383,8,375,150,98,54,41,6,12,0,0,1,1,0,0,0,1,2,0,3,1,5
649,52,775,194,581,6,575,8,567,252,118,77,71,22,7,0,1,0,0,0,0,1,0,1,0,4,0,13
650,52,824,174,650,13,637,4,633,320,115,53,96,17,8,0,1,0,0,0,0,0,0,1,1,6,2,13
651,52,644,169,475,3,472,6,466,200,99,47,67,11,3,3,0,0,0,1,0,0,0,0,2,9,0,24
652,52,654,179,475,4,471,4,467,228,87,51,61,15,10,0,0,0,0,0,0,0,0,1,0,3,0,11
653,52,517,146,371,4,367,3,364,165,73,47,42,21,6,0,1,0,0,0,0,0,1,0,0,1,0,7
654,52,553,172,381,1,380,1,379,163,83,38,59,12,5,0,0,0,1,0,2,0,0,0,0,6,0,10
655,52,714,148,566,2,564,8,556,269,103,68,78,11,10,0,0,0,0,1,0,0,1,0,0,1,0,14
656,52,717,188,529,2,527,7,520,239,103,57,74,18,8,0,0,0,0,0,0,0,1,0,0,2,0,18
657,52,537,104,433,5,428,8,420,205,95,34,56,5,10,0,0,0,0,0,1,0,0,0,0,5,0,9
658,52,543,103,440,1,439,2,437,227,88,36,58,11,9,0,0,0,0,0,0,0,0,0,0,2,0,6
659,52,831,148,683,4,679,4,675,319,138,59,120,10,11,0,0,0,1,1,0,1,0,0,0,2,0,13
660,52,745,123,622,6,616,12,604,342,94,42,86,12,10,0,1,0,0,1,0,0,1,0,0,4,0,11
661,52,772,197,575,3,572,8,564,237,126,73,93,17,12,0,0,0,0,1,0,0,0,0,1,2,0,2
662,52,766,171,595,6,589,11,578,217,136,75,109,17,7,0,1,0,1,0,0,0,0,0,0,6,1,8
663,52,753,158,595,6,589,5,584,328,112,35,67,12,8,0,3,0,0,0,0,1,0,2,2,2,0,12
664,53,731,170,561,4,557,8,549,220,136,62,89,16,10,1,0,0,0,0,0,2,0,0,0,2,0,11
665,53,682,151,531,2,529,5,524,212,111,75,80,17,17,2,1,0,0,1,0,0,1,0,0,4,0,3
666,53,563,134,429,2,427,2,425,176,100,52,66,9,8,1,0,0,0,1,0,0,0,0,1,3,1,7
667,53,627,169,458,2,456,5,451,181,115,51,63,17,10,0,0,0,0,0,0,1,0,0,0,3,0,10
668,53,552,149,403,7,396,3,393,151,107,58,46,14,8,0,0,0,0,0,0,0,3,0,0,5,0,1
669,53,842,269,573,6,567,1,566,206,154,95,73,24,6,0,0,0,0,0,2,0,0,0,1,1,1,3
670,53,589,168,421,2,419,4,415,164,97,51,56,19,7,0,1,0,0,0,0,0,0,0,0,9,0,11
671,53,557,179,378,3,375,6,369,149,82,52,48,22,6,1,0,0,1,0,0,0,0,0,1,2,0,5
672,53,994,258,736,4,732,12,720,420,122,48,85,13,6,0,1,0,0,1,0,0,0,1,0,2,1,20
673,53,634,196,438,6,432,2,430,175,98,67,46,17,11,0,1,0,0,1,1,0,0,0,0,2,0,11
674,53,656,196,460,4,456,2,454,164,131,70,48,20,7,0,0,0,0,0,0,0,1,0,2,4,0,7
675,53,677,180,497,7,490,4,486,204,125,74,51,15,8,0,0,0,0,1,1,0,1,0,1,3,0,2
676,53,661,202,459,3,456,2,454,178,96,72,55,23,12,1,0,0,0,0,1,1,1,1,0,7,0,6
677,53,641,199,442,5,437,8,429,162,108,69,47,14,8,0,1,0,0,0,1,0,0,0,2,4,0,13
678,53,654,188,466,5,461,3,458,158,112,83,61,20,9,0,1,0,0,1,0,0,0,2,0,1,0,10
679,53,655,217,438,4,434,3,431,165,107,80,54,15,3,0,0,0,0,0,0,0,0,0,0,1,0,6
680,53,567,182,385,4,381,5,376,146,110,40,41,17,9,0,1,0,0,0,0,0,0,0,0,8,1,3
681,53,936,232,704,1,703,8,695,309,162,104,70,21,6,1,0,0,0,1,0,0,2,0,1,8,2,8
682,53,993,193,800,0,800,9,791,448,141,59,86,13,14,1,0,0,0,0,0,0,0,0,1,3,0,25
683,53,541,167,374,4,370,3,367,119,91,47,63,22,11,0,0,0,1,0,1,0,1,1,1,1,0,8
684,53,543,142,401,7,394,6,388,154,93,61,51,7,8,1,1,0,0,0,2,0,0,0,0,4,1,5
685,54,575,100,475,2,473,5,468,241,82,42,64,11,4,0,0,0,0,0,1,0,1,0,1,4,0,17
686,54,566,135,431,4,427,3,424,200,83,42,62,10,9,0,0,0,0,0,1,2,0,0,1,2,0,12
687,54,570,119,451,1,450,2,448,234,82,41,60,14,8,0,0,0,0,0,1,0,0,0,0,1,0,7
688,54,569,147,422,2,420,5,415,200,95,35,60,7,6,0,0,0,0,0,0,0,0,0,0,3,1,8
689,54,838,212,626,1,625,8,617,310,128,51,83,24,9,0,1,0,0,0,1,0,1,0,0,3,0,6
690,54,757,180,577,4,573,5,568,277,134,39,69,14,12,0,0,0,0,0,0,1,0,0,0,5,0,17
691,54,603,160,443,2,441,2,439,229,87,23,67,9,9,0,0,0,0,0,0,0,0,0,1,1,0,13
692,54,628,152,476,3,473,7,466,257,74,30,74,10,5,0,1,0,0,0,0,0,0,0,0,3,0,12
693,54,598,149,449,3,446,9,437,220,71,33,80,8,5,0,1,0,0,0,0,2,1,0,0,1,0,15
694,54,588,166,422,1,421,2,419,221,65,23,68,7,12,0,0,0,0,0,0,1,1,0,2,1,0,18
695,54,572,156,416,1,415,2,413,199,93,43,48,10,7,0,0,0,0,0,0,0,0,0,0,3,0,10
696,54,577,161,416,6,410,4,406,161,91,51,58,26,11,0,0,0,0,0,0,0,0,0,0,2,1,5
697,54,922,254,668,2,666,8,658,311,139,74,99,15,9,0,0,0,0,0,0,0,0,0,2,4,0,5
698,54,715,186,529,2,527,3,524,260,87,53,73,13,7,0,1,0,0,1,0,0,0,2,1,5,1,20
699,54,771,183,588,0,588,6,582,292,93,48,79,15,14,0,2,1,0,0,0,0,1,0,1,6,0,30
700,54,593,189,404,2,402,6,396,162,84,47,66,7,7,0,0,0,0,0,0,0,2,2,3,7,0,9
701,54,562,156,406,1,405,8,397,199,83,38,51,7,5,0,0,0,0,0,1,0,0,0,1,1,0,11
702,54,577,169,408,0,408,2,406,194,66,44,71,11,4,0,0,0,1,0,0,0,0,0,0,2,1,12
703,54,814,204,610,4,606,7,599,355,82,19,95,9,6,1,0,0,0,1,0,1,0,0,0,2,1,27
704,54,833,197,636,1,635,6,629,399,79,21,83,7,10,0,1,0,0,0,1,1,0,0,0,0,0,27
705,54,710,176,534,0,534,8,526,342,65,28,56,5,4,1,0,0,0,0,0,1,0,0,0,2,1,21
706,54,628,129,499,4,495,2,493,324,64,19,45,11,7,1,1,0,0,0,0,0,1,0,1,4,0,15
707,54,640,166,474,2,472,3,469,307,51,23,56,9,5,0,1,0,0,1,2,0,1,0,0,3,0,10
708,54,820,254,566,5,561,1,560,348,67,33,74,12,4,0,2,1,0,1,1,0,0,0,0,2,1,14
709,54,769,232,537,2,535,2,533,314,74,34,81,6,6,0,1,0,0,1,3,0,0,0,0,2,0,11
710,54,948,291,657,2,655,14,641,339,109,45,106,11,8,0,2,0,0,0,3,2,0,0,0,5,0,11
711,54,949,226,723,1,722,17,705,466,72,33,79,17,8,0,1,0,0,0,1,0,1,0,0,1,0,26
712,54,903,258,645,6,639,9,630,433,61,25,71,4,4,0,0,1,1,1,0,1,0,0,1,2,0,25
713,54,922,242,680,1,679,10,669,458,54,21,84,4,9,2,0,0,0,0,0,0,0,0,0,3,0,34
714,54,662,156,506,1,505,8,497,360,41,10,52,2,8,0,0,0,0,0,1,0,0,0,1,0,1,21
715,54,602,139,463,0,463,7,456,336,39,9,49,6,5,0,0,0,0,1,0,0,0,0,0,0,0,11
716,54,672,159,513,4,509,6,503,344,48,9,77,4,5,1,0,0,0,2,2,0,0,0,0,1,0,10
717,54,569,163,406,3,403,5,398,234,56,20,64,5,5,0,0,0,0,0,0,0,0,0,1,0,0,13
718,54,629,144,485,4,481,4,477,279,69,20,75,5,8,0,0,0,0,2,1,0,1,0,0,2,0,15
719,54,908,289,619,3,616,5,611,294,93,63,103,20,12,0,1,0,0,0,0,0,1,0,0,4,1,19
720,55,819,227,592,1,591,6,585,345,66,26,104,9,16,0,1,0,0,0,0,0,0,0,0,3,0,15
721,55,793,219,574,1,573,8,565,359,48,23,98,4,12,0,0,0,0,0,0,0,0,0,1,3,0,17
722,55,599,149,450,0,450,2,448,288,51,13,61,5,6,0,0,0,0,0,1,1,2,0,0,3,1,16
723,55,631,176,455,2,453,4,449,289,55,11,71,2,2,0,0,0,0,0,0,1,1,0,1,1,0,15
724,55,679,168,511,2,509,2,507,344,46,17,60,5,7,0,3,0,0,0,0,0,0,0,1,4,0,20
725,55,638,145,493,0,493,4,489,332,38,18,56,7,11,0,0,0,1,0,0,0,1,0,0,3,1,21
726,55,531,142,389,3,386,2,384,257,48,11,44,4,5,0,1,0,0,0,0,0,1,0,0,1,0,12
727,55,557,120,437,1,436,6,430,299,25,10,61,5,5,0,0,0,0,0,0,2,0,0,0,3,1,19
728,55,605,148,457,0,457,5,452,306,55,15,56,0,4,0,0,0,0,0,0,0,0,0,0,0,0,16
729,55,620,154,466,0,466,1,465,302,58,10,75,2,8,0,0,0,0,1,0,0,1,0,0,1,0,7
730,55,791,183,608,0,608,8,600,407,46,24,84,7,6,0,1,0,0,1,0,0,1,0,0,2,0,21
731,55,818,191,627,1,626,9,617,392,65,27,86,7,5,0,1,0,0,0,0,1,0,0,0,5,0,28
732,55,528,123,405,0,405,3,402,273,43,12,56,2,7,0,0,0,0,0,0,0,0,0,0,0,0,9
733,55,479,112,367,2,365,6,359,244,34,10,48,1,2,0,0,0,0,1,0,0,0,0,0,3,1,15
734,55,668,134,534,2,532,0,532,305,73,31,77,5,7,0,1,0,0,0,0,0,0,0,1,6,0,26
735,55,723,211,512,4,508,2,506,278,90,46,65,9,7,0,0,0,1,0,0,0,0,0,1,2,1,6
736,55,670,199,471,0,471,5,466,266,70,32,59,14,2,0,0,0,0,2,0,0,0,0,0,4,1,16
737,55,828,211,617,0,617,4,613,285,129,81,60,18,12,0,0,0,2,0,1,2,0,0,1,6,2,14
738,55,663,145,518,3,515,6,509,262,82,40,80,15,8,0,0,0,0,0,0,0,0,0,2,3,0,17
739,55,647,148,499,6,493,7,486,237,65,47,81,17,8,0,4,0,0,0,0,1,0,0,1,7,0,18
740,55,844,182,662,2,660,8,652,406,76,34,88,9,7,0,0,0,0,0,1,0,2,0,1,2,0,26
741,55,871,207,664,3,661,6,655,420,76,31,90,15,9,0,1,0,0,0,0,0,0,0,0,3,1,9
742,55,721,213,508,2,506,4,502,266,80,43,59,27,11,0,0,0,0,0,0,1,1,0,0,1,0,13
743,55,696,203,493,2,491,12,479,225,105,40,75,6,9,0,0,0,0,1,0,0,0,1,0,6,0,11
744,55,687,170,517,3,514,6,508,239,96,51,80,16,9,0,1,0,0,0,0,2,0,0,0,3,0,11
745,55,636,136,500,5,495,8,487,263,72,40,74,12,5,0,0,0,0,0,1,0,0,0,0,2,0,18
746,56,702,190,512,3,509,10,499,304,58,19,74,5,15,0,0,0,0,0,0,0,0,0,0,4,1,19
747,56,721,196,525,4,521,6,515,345,46,31,69,3,3,0,3,0,0,0,0,1,0,0,0,1,0,13
748,56,969,332,637,3,634,4,630,284,133,65,97,13,21,0,2,0,1,0,0,0,0,0,0,2,1,11
749,56,719,185,534,10,524,5,519,271,98,46,77,3,12,0,0,0,0,0,0,0,0,0,0,2,1,9
750,56,724,190,534,10,524,5,519,271,98,46,77,3,12,0,0,0,0,0,0,0,0,0,0,2,1,9
751,56,636,172,464,0,464,5,459,248,79,39,59,3,8,0,1,0,1,1,0,0,1,0,0,1,0,18
752,56,588,137,451,1,450,5,445,282,57,22,50,6,5,0,0,0,0,0,0,0,0,0,2,3,1,17
753,56,844,233,611,5,606,2,604,287,124,57,67,23,5,0,2,0,0,0,2,0,1,1,0,3,0,32
754,56,684,196,488,2,486,10,476,210,118,68,49,12,5,0,0,0,0,0,0,0,1,1,2,0,0,10
755,56,509,191,318,2,316,1,315,48,144,69,31,14,1,4,0,0,0,0,0,0,0,0,0,3,0,1
756,56,553,177,376,3,373,6,367,82,144,85,28,11,9,0,0,1,0,0,0,0,1,0,0,3,0,3
757,56,628,153,475,6,469,1,468,247,60,32,93,7,6,0,0,0,0,0,0,0,1,1,0,4,0,17
758,56,699,156,543,2,541,7,534,273,83,49,104,7,5,0,0,0,0,0,1,0,0,0,0,5,0,7
759,56,656,176,480,5,475,9,466,229,79,34,91,6,11,0,0,0,0,0,0,0,1,0,0,0,0,15
760,56,707,154,553,2,551,6,545,305,82,32,83,12,6,0,0,0,1,0,0,2,0,0,0,5,0,17
761,56,705,162,543,1,542,3,539,296,84,28,101,5,6,0,0,0,0,0,0,0,0,0,3,1,0,15
762,56,956,193,763,4,759,11,748,349,118,63,150,15,20,0,1,0,0,0,1,1,0,0,0,3,0,27
763,56,985,219,766,4,762,10,752,376,125,59,132,17,16,0,1,0,0,0,0,1,0,1,2,1,0,21
764,61,906,366,540,4,536,4,532,182,157,94,50,20,15,0,2,0,0,0,1,0,2,0,1,2,0,6
765,61,642,228,414,3,411,2,409,120,149,67,33,10,13,0,2,0,0,0,1,0,3,0,0,3,0,8
766,61,530,176,354,1,353,2,351,107,100,67,50,12,8,0,0,0,0,0,0,0,1,0,0,2,1,3
767,61,528,174,354,2,352,3,349,101,80,74,53,13,14,1,0,0,0,1,0,1,1,0,0,6,0,4
768,61,772,323,449,3,446,1,445,131,124,96,39,32,6,1,1,0,0,0,0,0,0,0,3,5,1,6
769,61,705,293,412,3,409,9,400,105,135,73,46,19,7,1,0,0,0,0,0,1,1,0,0,7,1,4
770,61,606,247,359,4,355,6,349,98,90,95,34,13,9,0,0,1,0,1,0,1,1,0,0,3,0,3
771,61,750,269,481,4,477,8,469,167,153,55,49,18,16,0,0,0,0,1,0,0,1,0,0,2,1,6
772,61,775,297,478,1,477,0,477,189,114,96,49,12,6,0,0,0,0,0,0,0,0,1,3,4,2,1
773,61,853,258,595,5,590,7,583,223,167,99,43,22,14,0,0,0,0,0,1,0,0,2,0,7,3,2
774,61,688,144,544,0,544,2,542,219,121,73,71,23,13,0,1,0,0,0,1,1,0,0,1,4,0,14
775,61,742,170,572,6,566,5,561,233,135,76,60,27,15,0,0,0,0,0,0,1,2,0,0,2,1,9
776,61,858,337,521,4,517,11,506,152,135,122,38,31,10,0,0,0,1,0,0,0,1,0,1,7,0,8
777,61,685,258,427,8,419,7,412,142,113,88,31,20,8,1,0,0,0,2,0,0,0,1,0,5,0,1
778,61,712,281,431,11,420,7,413,131,117,80,44,16,15,0,0,0,1,0,0,0,1,0,0,2,1,5
779,61,820,293,527,8,519,6,513,202,134,72,62,18,11,0,1,0,3,1,1,0,2,0,1,3,1,1
780,61,690,299,391,5,386,3,383,132,123,70,28,16,5,0,0,0,1,0,1,0,1,0,0,2,3,1
781,61,546,199,347,2,345,0,345,114,108,62,30,13,6,0,0,0,0,1,0,1,1,0,1,5,1,2
782,61,566,216,350,1,349,2,347,116,102,68,32,12,8,0,1,0,0,0,0,0,0,1,0,4,0,3
783,61,707,310,397,0,397,4,393,126,108,94,24,15,16,0,1,0,0,0,0,0,0,1,0,5,3,0
784,61,917,363,554,8,546,0,546,196,124,107,69,20,20,0,0,0,0,0,0,0,0,0,0,1,4,5
785,61,637,261,376,4,372,7,365,133,101,60,29,18,12,0,0,0,0,1,1,1,1,2,0,3,0,3
786,61,664,319,345,1,344,1,343,106,115,68,22,17,8,0,0,0,0,1,1,0,0,0,0,4,0,1
787,61,538,222,316,4,312,2,310,93,94,58,33,18,4,0,0,0,0,1,1,0,4,1,0,2,0,1
788,61,578,245,333,4,329,4,325,93,108,63,25,17,8,0,0,0,1,2,0,1,0,0,0,1,0,6
789,61,855,292,563,6,557,5,552,220,133,83,67,16,14,0,3,0,0,1,0,0,0,0,1,2,0,12
790,61,633,183,450,2,448,7,441,141,112,77,69,22,14,1,0,0,0,0,0,0,0,0,0,2,0,3
791,61,665,151,514,3,511,6,505,170,150,82,66,20,5,1,1,0,0,0,0,0,0,0,0,3,0,7
792,62,565,208,357,2,355,1,354,128,91,60,47,10,8,0,0,0,0,2,0,0,0,0,0,2,1,5
793,62,758,339,419,6,413,2,411,145,119,69,33,23,7,0,0,0,0,0,0,0,0,0,0,6,1,8
794,62,751,277,474,1,473,8,465,193,121,57,43,16,10,0,1,0,0,1,1,1,0,1,0,6,0,14
795,62,900,286,614,2,612,8,604,297,122,57,78,20,10,0,1,0,0,0,0,0,0,0,0,6,0,13
796,62,552,84,468,0,468,9,459,315,37,23,55,1,5,0,1,0,0,0,0,0,0,0,0,3,0,19
797,62,541,111,430,3,427,12,415,275,57,18,41,3,4,0,3,0,0,0,0,0,0,0,1,1,0,12
798,62,628,197,431,4,427,5,422,221,77,34,68,8,6,0,0,0,0,1,0,0,0,0,0,0,0,7
799,62,634,186,448,0,448,0,448,254,50,47,77,7,5,0,0,0,0,2,0,0,1,0,0,2,0,3
800,62,935,236,699,5,694,7,687,360,125,69,88,11,20,0,2,0,0,0,0,0,0,0,2,3,1,6
801,62,798,314,484,5,479,7,472,150,124,86,60,23,12,0,0,0,1,0,1,0,1,0,2,6,0,6
802,62,948,351,597,3,594,5,589,227,146,100,71,16,10,1,3,0,1,0,2,0,1,0,1,4,0,6
803,62,615,219,396,2,394,1,393,127,118,69,42,21,6,0,0,0,0,0,0,0,0,0,0,7,1,2
804,62,572,197,375,1,374,1,373,165,96,51,31,12,9,0,1,0,0,0,0,0,0,2,0,4,0,2
805,62,530,186,344,3,341,3,338,129,87,53,42,12,7,0,0,0,0,0,1,0,0,0,0,3,1,3
806,62,730,234,496,1,495,3,492,157,146,93,52,23,7,0,1,0,0,0,0,0,0,1,0,8,0,4
807,62,795,289,506,7,499,2,497,221,114,74,43,16,12,1,2,0,1,0,0,1,1,0,0,5,0,6
808,62,669,140,529,5,524,4,520,329,81,29,49,5,8,1,0,0,0,1,0,0,0,1,0,0,0,16
809,62,663,167,496,1,495,6,489,314,52,27,48,7,5,1,5,0,0,0,0,0,1,0,0,1,0,28
810,62,909,187,722,4,718,10,708,438,88,42,97,0,12,0,3,0,1,0,0,0,0,1,1,2,0,23
811,62,644,189,455,1,454,6,448,218,82,50,67,10,7,0,1,0,0,0,2,0,0,0,1,3,0,7
812,62,733,252,481,3,478,9,469,230,98,55,50,13,8,1,0,0,0,0,0,0,0,0,1,1,0,12
813,62,665,211,454,3,451,6,445,189,115,62,48,12,6,0,0,0,0,0,0,3,0,0,0,6,0,4
814,62,693,242,451,2,449,6,443,199,100,58,49,13,8,0,1,0,0,0,1,0,1,0,0,5,2,6
815,62,551,189,362,5,357,4,353,128,80,66,49,12,4,0,1,0,0,0,0,0,1,0,2,4,1,5
816,62,499,162,337,3,334,2,332,113,80,53,49,16,8,0,0,0,0,1,0,0,0,0,1,6,0,5
817,62,833,212,621,5,616,9,607,344,82,55,81,13,5,0,1,0,0,0,2,0,1,0,1,4,0,18
818,62,933,211,722,3,719,6,713,344,117,80,99,24,17,0,0,0,0,0,1,0,1,0,2,4,0,24
819,62,622,193,429,1,428,3,425,238,59,32,53,9,11,0,2,0,1,0,0,0,1,0,0,4,0,15
820,62,639,194,445,2,443,7,436,264,53,28,58,3,5,0,2,0,0,0,1,1,0,0,0,1,0,20
821,62,810,197,613,3,610,10,600,312,106,45,87,7,10,0,2,0,0,0,0,1,0,0,0,4,0,26
822,62,638,206,432,4,428,4,424,213,71,40,59,8,10,0,1,0,1,0,1,0,0,0,2,1,0,17
823,62,542,164,378,3,375,2,373,197,54,40,57,9,7,0,0,0,0,0,0,0,1,0,0,3,0,5
824,62,983,235,748,3,745,13,732,298,172,96,94,28,17,0,0,0,0,0,0,1,2,0,3,4,0,17
825,62,836,220,616,2,614,20,594,244,165,74,64,18,13,0,0,0,0,0,1,1,0,0,1,5,0,8
826,62,969,353,616,4,612,6,606,291,118,79,60,21,9,0,0,0,0,1,0,1,2,0,1,4,0,19
827,62,853,257,596,2,594,6,588,264,127,70,68,28,13,1,0,0,0,0,1,0,0,0,0,6,1,9
828,63,711,294,417,1,416,4,412,147,118,72,46,11,4,1,0,0,0,1,0,0,0,0,0,4,2,6
829,63,789,305,484,5,479,6,473,193,130,74,43,16,5,0,0,0,0,1,0,0,0,1,0,5,0,5
830,63,540,160,380,4,376,3,373,142,103,56,34,15,8,0,0,1,0,1,2,0,0,0,0,4,0,7
831,63,575,162,413,3,410,0,410,164,102,57,55,9,11,0,0,0,0,0,1,0,0,0,0,4,1,6
832,63,959,303,656,7,649,4,645,286,153,86,72,15,15,0,1,0,0,0,0,1,0,0,0,4,2,10
833,63,788,234,554,2,552,7,545,306,77,32,94,7,8,0,1,0,0,1,0,0,0,0,1,6,0,12
834,63,771,217,554,7,547,4,543,215,148,74,49,24,19,1,0,0,0,1,0,0,0,0,0,5,1,6
835,63,848,265,583,4,579,1,578,334,60,56,82,9,15,0,1,0,0,0,1,0,1,0,0,4,1,14
836,63,783,201,582,1,581,7,574,362,56,26,86,10,8,0,0,0,0,1,2,0,1,0,0,5,0,17
837,63,748,184,564,1,563,1,562,340,59,31,96,8,6,0,2,0,0,1,1,0,1,0,1,3,0,13
838,63,950,218,732,3,729,10,719,484,77,29,79,2,12,0,2,0,0,1,0,0,0,0,2,2,0,29
839,63,609,130,479,0,479,5,474,372,26,9,47,2,2,0,0,0,0,1,1,0,0,0,1,0,0,13
840,63,686,150,536,0,536,4,532,360,37,32,80,3,4,0,0,0,0,0,0,1,0,0,3,0,0,12
841,63,511,151,360,1,359,2,357,166,60,42,55,8,9,0,2,0,0,1,0,0,0,0,0,4,4,6
842,63,521,154,367,1,366,3,363,176,74,32,54,8,4,0,0,0,0,0,0,0,0,1,0,5,0,9
843,63,847,291,556,4,552,4,548,225,123,73,68,17,21,0,1,0,0,0,1,1,0,1,0,9,2,6
844,63,967,337,630,12,618,4,614,230,160,117,59,17,12,0,1,0,0,0,0,0,0,2,1,9,1,5
845,63,525,198,327,2,325,2,323,124,77,47,40,14,2,0,1,0,1,0,1,0,1,0,1,8,1,5
846,63,545,192,353,5,348,4,344,126,92,46,47,13,2,0,1,0,0,1,2,0,1,0,1,8,0,4
847,63,535,185,350,3,347,4,343,152,63,52,48,15,6,0,2,0,0,0,0,0,0,0,1,1,0,3
848,63,491,162,329,2,327,6,321,142,61,36,53,11,5,0,0,0,0,0,1,3,1,0,0,4,0,4
849,63,739,217,522,1,521,0,521,322,77,25,58,8,9,0,0,0,0,0,0,0,0,0,1,3,0,18
850,64,819,272,547,4,543,6,537,237,114,74,66,19,9,0,1,0,1,0,1,0,1,1,0,4,0,9
851,64,737,245,492,1,491,4,487,191,112,91,57,14,7,0,0,0,0,0,0,0,3,0,2,3,1,6
852,64,585,203,382,4,378,6,372,99,127,76,46,16,3,0,0,0,0,0,0,0,2,0,1,2,0,0
853,64,550,173,377,1,376,3,373,97,114,78,43,20,9,0,0,0,1,1,0,0,1,0,0,6,1,2
854,64,746,320,426,1,425,2,423,106,117,106,43,21,11,0,0,0,1,1,3,0,0,0,1,8,0,5
855,64,808,294,514,10,504,0,504,148,141,111,51,17,15,2,1,0,2,1,0,0,3,0,2,8,0,2
856,64,741,258,483,3,480,2,478,218,84,78,53,19,10,0,0,0,0,0,0,0,1,0,1,2,1,11
857,64,710,198,512,6,506,4,502,205,134,53,55,17,10,1,0,0,0,0,0,0,0,0,3,4,1,19
858,64,790,298,492,2,490,12,478,170,101,85,64,20,9,0,4,0,0,0,2,0,0,0,1,9,1,12
859,64,817,274,543,4,539,6,533,242,126,62,50,23,11,0,0,0,1,0,0,0,1,2,1,7,0,7
860,64,676,240,436,6,430,5,425,147,123,78,46,15,4,0,0,0,0,1,1,0,0,1,1,4,1,3
861,64,902,407,495,3,492,0,492,106,157,133,42,19,9,1,0,0,1,1,4,0,1,0,3,7,5,3
862,64,905,384,521,6,515,5,510,112,174,136,47,19,4,0,0,0,0,1,0,0,1,4,2,5,2,3
863,64,602,264,338,4,334,9,325,63,110,94,27,19,5,2,0,0,0,1,0,0,1,1,1,1,0,0
864,64,585,262,323,1,322,4,318,68,108,79,24,14,11,1,0,0,0,0,0,0,1,0,1,7,2,2
865,64,579,246,333,3,330,7,323,109,87,72,23,16,2,1,0,0,0,1,0,0,1,0,0,8,0,3
866,64,550,203,347,2,345,5,340,110,84,80,37,12,3,0,0,1,0,0,1,0,2,0,0,3,1,6
867,64,949,370,579,5,574,6,568,121,192,130,53,41,13,0,0,0,1,1,0,1,1,1,2,9,0,2
868,64,590,245,345,3,342,1,341,80,115,87,21,16,6,1,1,1,0,0,0,0,0,1,0,6,0,6
869,64,582,239,343,3,340,4,336,81,95,79,42,13,4,0,0,1,1,0,1,0,2,0,2,9,3,3
870,64,562,201,361,2,359,0,359,103,117,71,32,17,12,0,0,0,0,0,1,0,0,0,2,2,0,2
871,64,551,205,346,1,345,0,345,92,120,56,43,14,5,0,0,0,0,0,0,1,3,0,1,8,1,1
872,64,650,252,398,2,396,4,392,114,108,75,56,19,9,0,0,0,1,2,0,0,0,0,1,3,1,3
873,64,556,205,351,3,348,5,343,132,100,45,36,17,6,0,0,0,1,1,0,0,0,0,0,2,1,2
874,65,711,261,450,3,447,5,442,123,116,108,45,21,15,0,0,1,0,0,0,0,0,0,2,5,1,5
875,65,619,246,373,2,371,0,371,84,113,78,54,16,7,1,0,0,1,1,1,0,0,1,0,6,1,7
876,65,548,210,338,3,335,3,332,104,102,64,34,12,7,0,0,0,0,0,0,0,0,0,1,6,2,0
877,65,529,213,316,2,314,3,311,101,93,71,27,8,5,0,1,0,0,0,0,0,0,1,1,1,0,2
878,65,860,306,554,3,551,2,549,157,178,74,77,28,21,2,0,0,0,0,0,2,2,0,2,5,0,1
879,65,828,319,509,1,508,4,504,135,161,99,59,23,10,0,1,1,0,0,1,0,3,2,0,2,1,6
880,65,615,221,394,1,393,1,392,127,86,86,51,22,11,0,0,0,0,1,1,0,2,0,0,2,0,3
881,65,639,230,409,2,407,3,404,107,139,76,44,17,14,2,0,0,0,0,1,0,1,2,0,1,0,0
882,65,768,318,450,6,444,8,436,95,143,99,48,27,6,0,1,0,1,1,1,0,0,0,2,8,0,4
883,65,792,330,462,3,459,2,457,118,127,91,68,24,10,1,0,0,0,2,0,0,0,1,2,8,1,4
884,65,521,195,326,5,321,5,316,117,71,55,27,16,18,1,0,0,0,0,1,0,5,1,1,3,0,0
885,65,503,213,290,0,290,4,286,88,80,51,41,13,9,0,0,0,0,0,0,0,1,0,1,1,0,1
886,65,589,245,344,4,340,1,339,100,80,81,38,15,9,1,1,0,2,0,0,0,0,4,1,5,1,1
887,65,1024,453,571,9,562,12,550,164,151,108,70,29,11,1,0,0,2,2,0,0,4,1,0,5,1,1
888,65,888,380,508,8,500,8,492,104,150,112,53,26,21,0,0,1,0,1,0,0,1,0,0,17,0,6
889,65,560,210,350,0,350,3,347,78,111,69,53,14,13,1,0,0,0,1,0,0,0,0,1,0,0,6
890,65,585,213,372,1,371,4,367,85,110,88,40,24,11,0,0,0,0,0,0,0,1,1,1,3,0,3
891,65,509,165,344,3,341,2,339,82,100,83,43,17,5,0,0,0,0,0,1,0,2,0,0,5,0,1
892,65,526,196,330,2,328,3,325,77,93,86,37,19,5,0,0,0,0,0,0,0,1,0,0,6,0,1
893,65,814,321,493,6,487,12,475,92,160,113,62,21,10,0,0,0,1,0,1,0,0,1,2,5,3,4
894,65,596,213,383,5,378,3,375,89,110,87,49,17,13,0,0,0,0,0,0,0,1,1,2,3,0,3
895,65,676,231,445,5,440,2,438,141,116,104,45,14,7,0,0,0,1,0,0,1,1,0,0,5,0,3
896,65,821,318,503,3,500,5,495,159,141,86,59,21,12,0,0,0,1,1,3,0,1,1,1,7,1,1
897,65,1004,332,672,10,662,2,660,275,150,111,57,34,14,0,1,0,0,1,0,0,1,2,1,5,0,8
898,65,889,356,533,6,527,5,522,143,161,92,75,26,13,1,0,0,0,2,1,0,1,0,1,4,0,2
899,66,773,303,470,4,466,3,463,171,116,74,51,21,19,0,0,0,0,0,0,0,0,0,0,6,0,5
900,66,592,236,356,0,356,3,353,100,100,77,42,15,8,0,0,0,0,0,0,0,1,0,0,7,0,3
901,66,659,270,389,2,387,2,385,117,112,75,48,16,6,0,2,0,1,0,0,0,2,0,0,3,1,2
902,66,927,336,591,1,590,11,579,154,155,126,79,29,18,0,1,0,0,0,1,0,0,0,0,6,0,10
903,66,660,201,459,4,455,4,451,110,135,94,66,23,10,0,0,0,1,0,0,0,0,1,2,7,0,2
904,66,588,200,388,5,383,6,377,100,99,81,56,18,15,0,0,0,0,0,0,0,0,0,1,5,1,1
905,66,736,270,466,7,459,6,453,126,144,87,59,21,4,0,0,0,0,1,1,0,2,0,0,2,1,5
906,66,746,274,472,2,470,4,466,137,133,82,73,19,11,0,0,0,0,0,0,0,0,0,0,6,1,4
907,66,607,208,399,10,389,4,385,104,96,87,45,23,14,3,0,0,0,0,0,0,1,0,1,6,1,4
908,66,656,238,418,8,410,5,405,102,112,88,57,19,15,1,2,0,0,0,0,0,1,0,0,7,0,1
909,66,738,279,459,7,452,7,445,132,147,79,38,25,8,0,0,0,0,0,1,1,0,2,0,4,4,4
910,66,726,274,452,12,440,7,433,121,146,77,39,19,16,1,0,0,0,1,1,0,1,1,1,8,0,1
911,66,767,270,497,5,492,4,488,123,167,104,51,13,15,0,0,0,1,0,0,0,0,1,2,5,2,4
912,66,618,210,408,0,408,5,403,145,107,72,45,21,6,0,0,0,0,0,1,0,0,0,0,2,1,3
913,66,698,252,446,1,445,11,434,131,142,87,47,6,6,0,0,2,0,0,1,0,1,1,0,1,0,9
914,66,665,249,416,2,414,2,412,177,113,55,39,6,10,0,0,0,0,0,0,0,2,0,1,4,0,5
915,66,645,248,397,5,392,2,390,137,101,76,45,13,6,0,0,0,0,1,0,0,1,1,0,4,0,5
916,66,935,362,573,10,563,5,558,194,167,99,59,16,11,0,0,0,1,0,1,0,1,0,0,4,0,5
917,66,880,286,594,3,591,6,585,215,155,105,47,34,6,1,0,1,0,0,1,1,2,0,3,9,0,5
918,66,629,209,420,10,410,4,406,167,96,73,35,13,6,1,1,0,0,0,1,0,0,1,1,9,0,2
919,66,605,191,414,1,413,7,406,185,99,56,38,9,6,2,1,0,0,0,1,0,0,2,0,6,0,1
920,66,879,321,558,6,552,1,551,200,134,114,56,22,14,0,0,0,0,1,1,0,1,0,2,3,1,2
921,66,745,297,448,2,446,5,441,152,102,88,52,27,7,0,0,0,1,1,2,0,1,0,1,1,0,6
922,71,884,292,592,6,586,5,581,266,112,64,79,23,14,1,0,0,0,0,0,0,3,0,1,5,0,13
923,71,680,198,482,6,476,3,473,198,110,67,51,22,10,0,0,0,0,0,0,0,0,1,1,4,2,7
924,71,902,290,612,7,605,9,596,262,117,88,69,28,10,0,0,0,0,0,1,1,1,0,2,2,1,14
925,71,713,207,506,10,496,5,491,191,111,82,61,19,16,0,1,0,0,0,0,1,1,0,0,1,0,7
926,71,535,170,365,2,363,7,356,141,69,62,48,16,8,0,1,0,0,1,0,0,0,0,0,3,0,7
927,71,573,135,438,4,434,8,426,226,61,35,52,9,12,1,1,0,1,0,1,0,0,0,4,2,2,19
928,71,612,161,451,0,451,9,442,215,83,53,55,10,6,0,2,0,0,0,2,0,0,0,1,8,0,7
929,71,718,173,545,1,544,3,541,218,128,86,60,28,6,0,0,0,0,0,0,0,0,0,1,1,0,13
930,71,524,116,408,3,405,4,401,238,59,41,42,10,2,0,0,0,0,0,0,0,0,0,0,1,0,8
931,71,579,119,460,3,457,4,453,255,73,45,49,10,8,0,0,0,0,0,0,0,0,0,0,2,0,11
932,71,679,204,475,6,469,7,462,175,108,68,64,14,4,0,1,0,0,0,0,0,0,0,2,2,0,24
933,71,851,249,602,5,597,5,592,247,133,89,70,20,11,0,1,0,0,0,0,0,0,0,2,2,0,17
934,71,919,271,648,9,639,7,632,251,127,112,71,22,16,0,3,0,2,0,0,0,3,0,0,7,0,18
935,71,553,164,389,1,388,5,383,172,86,41,47,19,6,0,1,0,0,0,0,0,0,0,0,1,0,10
936,71,591,170,421,1,420,7,413,193,93,48,47,10,12,0,1,0,0,0,1,0,0,0,0,0,1,7
937,71,709,196,513,3,510,8,502,238,75,65,61,17,8,0,1,0,0,1,1,0,0,0,1,3,0,31
938,71,928,294,634,2,632,9,623,320,113,85,50,15,9,0,0,0,1,0,0,0,2,0,0,6,3,19
939,71,518,158,360,3,357,5,352,139,100,49,41,15,3,0,0,0,0,2,0,0,0,1,0,0,0,2
940,71,575,179,396,2,394,4,390,140,90,60,58,14,13,0,1,1,0,0,0,0,1,0,2,4,0,6
941,71,740,186,554,4,550,10,540,272,101,68,53,7,16,0,0,0,0,1,1,2,2,0,0,6,0,11
942,71,644,162,482,1,481,2,479,238,74,62,69,13,7,0,0,0,0,0,0,0,0,0,0,0,0,16
943,71,613,152,461,4,457,7,450,222,88,49,55,15,6,0,0,0,0,1,1,0,0,0,0,3,1,9
944,71,945,239,706,5,701,14,687,345,118,76,91,27,15,0,0,0,0,0,1,0,0,0,1,0,0,13
945,71,755,170,585,5,580,3,577,298,126,44,58,12,11,1,0,0,0,1,0,0,0,0,0,1,1,24
946,71,765,190,575,2,573,9,564,283,112,55,66,14,7,0,1,0,0,0,2,0,0,0,1,3,0,20
947,71,790,174,616,4,612,10,602,310,109,54,71,14,11,2,0,0,1,0,2,0,2,0,0,2,0,24
948,72,570,160,410,3,407,4,403,175,87,47,53,11,9,0,2,0,0,0,1,0,0,0,2,8,0,8
949,72,908,250,658,6,652,4,648,242,178,83,72,20,21,1,0,0,1,0,1,0,0,0,5,4,0,20
950,72,659,183,476,6,470,2,468,172,110,95,51,19,10,0,0,0,0,0,0,0,0,0,0,4,0,7
951,72,725,225,500,4,496,6,490,185,120,79,65,22,6,1,0,0,0,0,0,0,3,0,0,1,0,8
952,72,1006,284,722,10,712,10,702,303,160,110,85,16,4,1,0,0,0,2,2,0,1,3,1,3,1,10
953,72,925,302,623,3,620,18,602,234,124,121,65,37,7,0,0,0,0,0,0,1,0,0,2,3,2,6
954,72,643,188,455,0,455,3,452,180,120,69,38,21,12,1,1,0,0,0,1,0,2,2,0,2,1,2
955,72,992,291,701,3,698,7,691,285,183,105,65,18,16,1,1,1,0,0,0,0,1,0,1,6,1,7
956,72,614,202,412,5,407,1,406,145,113,64,44,17,8,0,0,0,0,1,2,0,1,1,1,4,0,5
957,72,537,171,366,4,362,1,361,121,88,80,46,12,5,0,0,0,0,0,0,0,1,0,1,3,1,3
958,72,580,154,426,6,420,4,416,163,89,87,49,16,8,0,1,0,0,0,0,0,0,0,0,2,0,1
959,72,604,181,423,1,422,4,418,147,106,76,55,15,6,0,1,1,0,0,2,1,0,0,0,2,0,6
960,72,629,204,425,2,423,1,422,143,108,70,57,20,6,0,2,0,0,0,0,0,2,0,0,4,0,10
961,72,860,265,595,5,590,3,587,217,146,101,72,28,10,0,0,0,0,0,0,0,0,0,1,6,0,6
962,72,673,211,462,6,456,6,450,157,132,78,50,19,4,0,0,0,0,0,0,0,0,0,0,2,0,8
963,72,813,245,568,1,567,5,562,207,126,95,69,27,16,0,0,0,0,0,0,0,1,0,0,4,3,14
964,72,1014,256,758,4,754,2,752,294,164,123,97,31,12,1,0,0,0,1,0,1,3,0,0,3,1,21
965,72,828,169,659,3,656,7,649,347,125,44,85,13,5,0,0,0,0,0,0,2,1,1,3,0,0,23
966,72,943,258,685,10,675,3,672,362,134,58,66,21,11,0,0,0,0,0,0,0,0,0,0,4,0,16
967,72,749,140,609,5,604,9,595,344,109,38,58,17,8,0,0,0,0,0,1,0,0,1,1,4,0,14
968,72,714,236,478,6,472,4,468,210,85,84,45,22,9,0,1,0,0,0,1,0,0,0,0,3,0,8
969,72,598,175,423,3,420,2,418,169,85,71,53,16,12,0,0,0,0,0,0,0,0,0,0,6,1,5
970,72,879,266,613,1,612,5,607,244,138,85,76,28,13,1,2,0,0,0,0,0,0,0,0,7,1,12
971,72,692,179,513,5,508,7,501,230,99,58,70,16,6,0,0,0,0,0,0,0,0,0,0,2,0,20
972,72,726,201,525,7,518,7,511,240,97,57,69,21,10,1,0,0,0,0,2,0,1,1,0,4,0,8
973,72,569,155,414,2,412,2,410,215,81,38,43,9,10,0,1,0,0,0,0,0,0,0,0,4,0,9
974,73,665,240,425,1,424,3,421,162,104,71,46,18,3,0,0,1,0,0,1,0,0,0,0,4,1,10
975,73,582,159,423,1,422,2,420,163,90,73,49,23,7,0,0,0,1,0,0,0,0,0,2,6,0,6
976,73,549,159,390,4,386,8,378,170,85,53,45,6,7,0,0,0,0,0,0,0,0,0,0,2,1,9
977,73,1018,328,690,7,683,4,679,243,161,119,68,46,18,0,1,1,0,0,0,0,0,0,0,5,1,16
978,73,561,164,397,2,395,7,388,160,80,70,45,17,4,0,2,0,0,0,0,1,0,1,0,2,1,5
979,73,601,156,445,3,442,9,433,147,113,87,43,18,6,0,0,0,0,0,2,0,1,1,2,3,1,9
980,73,565,165,400,4,396,2,394,154,96,60,44,22,7,0,0,0,0,0,0,0,0,0,0,1,1,9
981,73,585,178,407,3,404,3,401,162,88,57,54,24,7,0,0,0,0,0,0,0,0,0,0,2,0,7
982,73,919,250,669,5,664,6,658,227,163,127,80,29,15,1,1,0,0,2,2,0,2,0,0,2,1,6
983,73,580,189,391,2,389,4,385,139,83,83,44,20,4,0,0,0,0,0,0,0,0,0,0,5,0,7
984,73,696,213,483,3,480,7,473,178,107,90,53,15,10,0,0,0,0,0,0,0,0,0,0,5,1,14
985,73,503,145,358,1,357,2,355,133,87,58,49,10,6,0,0,0,0,1,0,0,0,0,0,2,0,9
986,73,507,139,368,3,365,3,362,132,92,50,46,21,8,1,0,0,0,0,0,0,0,0,2,3,0,7
987,73,792,228,564,1,563,4,559,181,131,117,68,37,12,0,1,0,0,0,0,0,2,0,1,2,0,7
988,73,1009,248,761,4,757,5,752,277,159,126,112,30,20,0,0,0,0,0,0,0,3,0,0,9,1,15
989,73,902,222,680,4,676,5,671,313,136,82,78,25,17,1,0,0,0,0,0,0,0,0,1,7,0,11
990,73,988,330,658,6,652,5,647,259,156,112,72,31,8,0,0,0,0,1,2,1,1,0,0,2,0,2
991,73,830,248,582,3,579,3,576,208,144,93,71,27,15,0,1,0,0,0,1,0,1,1,0,4,1,9
992,73,781,184,597,6,591,6,585,220,137,107,76,25,3,0,1,0,2,0,0,0,1,1,0,4,1,7
993,73,857,248,609,5,604,9,595,250,131,85,74,34,10,2,2,0,1,0,0,0,0,0,1,1,0,4
994,73,774,220,554,0,554,4,550,184,126,90,77,29,11,0,1,0,0,0,0,0,2,0,0,8,0,22
995,73,923,291,632,4,628,3,625,218,162,108,72,26,13,0,0,0,1,0,1,1,0,0,1,11,0,11
996,73,780,213,567,2,565,9,556,265,125,67,62,16,6,0,0,0,0,0,0,0,0,0,1,2,0,12
997,73,603,146,457,3,454,4,450,209,95,47,59,25,4,0,0,0,0,0,0,0,0,0,2,1,0,8
998,73,660,159,501,6,495,1,494,243,94,58,57,15,10,0,1,0,0,2,0,0,1,0,2,2,0,9
999,73,505,147,358,2,356,2,354,172,63,39,56,6,4,0,0,0,0,0,2,1,0,0,0,2,0,9
1000,73,535,148,387,2,385,3,382,173,70,60,44,15,4,0,0,0,0,2,0,0,0,0,3,1,0,10
1001,74,782,218,564,3,561,2,559,358,72,39,57,9,3,1,0,0,0,0,0,0,0,0,0,3,0,17
1002,74,759,190,569,4,565,6,559,358,89,9,56,6,6,0,1,0,0,0,1,0,0,1,1,5,1,25
1003,74,769,199,570,4,566,8,558,346,78,35,55,8,13,0,0,0,0,0,2,0,1,0,2,2,0,16
1004,74,723,208,515,0,515,8,507,236,98,55,64,12,9,1,0,0,0,0,0,0,0,1,3,2,1,25
1005,74,945,240,705,0,705,7,698,422,95,46,66,20,5,0,0,2,0,0,2,0,0,0,0,4,0,36
1006,74,960,246,714,4,710,2,708,456,89,30,81,10,7,1,4,0,0,0,0,0,0,0,0,2,2,26
1007,74,808,202,606,4,602,6,596,340,80,41,81,15,17,1,1,0,0,0,0,0,1,0,0,4,1,14
1008,74,544,137,407,5,402,4,398,260,46,18,38,7,3,0,0,0,0,0,2,1,0,0,1,4,0,18
1009,74,884,196,688,0,688,3,685,456,73,28,74,13,5,1,1,0,0,0,0,0,0,1,1,5,0,27
1010,74,602,162,440,0,440,2,438,274,65,24,37,12,8,0,2,0,1,1,0,0,0,0,2,1,1,10
1011,74,582,142,440,0,440,2,438,304,53,15,38,10,2,0,0,0,0,1,0,0,0,0,1,2,0,12
1012,74,637,167,470,4,466,3,463,243,79,38,60,12,9,0,0,0,0,0,0,0,0,0,3,4,0,15
1013,74,706,194,512,5,507,9,498,279,77,34,73,7,8,0,0,0,0,2,0,0,0,1,0,4,0,13
1014,74,858,207,651,3,648,2,646,319,113,86,68,29,6,0,2,0,0,0,0,0,0,1,0,3,0,19
1015,74,548,167,381,3,378,4,374,144,81,73,45,13,7,0,0,0,0,0,1,0,0,0,0,4,0,6
1016,74,583,166,417,2,415,0,415,176,91,60,59,11,11,0,0,0,0,0,0,0,0,0,1,0,0,6
1017,74,719,252,467,0,467,6,461,192,118,58,47,17,13,0,1,0,0,2,0,0,0,0,2,2,1,8
1018,74,807,217,590,4,586,3,583,327,101,59,51,18,10,0,0,0,0,0,0,0,0,0,1,2,0,14
1019,74,941,234,707,1,706,3,703,450,89,35,86,9,2,0,2,0,0,0,0,0,0,1,1,0,1,27
1020,74,974,229,745,6,739,10,729,480,94,23,77,9,13,0,1,0,0,0,0,0,1,0,0,3,0,28
1021,75,627,162,465,2,463,4,459,267,65,32,58,9,6,0,0,0,0,0,0,0,0,0,0,2,1,19
1022,75,576,153,423,0,423,8,415,250,70,25,44,4,4,0,0,0,0,0,0,0,0,0,0,2,0,16
1023,75,530,121,409,1,408,9,399,227,48,36,61,7,3,0,1,0,0,0,0,1,0,0,0,0,0,15
1024,75,541,127,414,2,412,4,408,246,53,13,53,9,10,0,1,0,0,0,1,1,0,0,0,2,0,19
1025,75,873,222,651,3,648,8,640,346,117,59,76,7,6,0,0,0,0,0,1,0,0,0,0,3,1,24
1026,75,614,211,403,1,402,1,401,165,86,51,64,11,10,0,0,0,0,0,0,0,0,0,0,4,0,10
1027,75,774,162,612,3,609,5,604,325,96,66,72,21,4,0,0,0,0,0,0,0,0,0,0,4,0,16
1028,75,750,213,537,3,534,7,527,207,110,69,85,28,13,0,2,0,1,0,0,0,0,0,0,2,0,10
1029,75,642,198,444,5,439,7,432,187,95,57,56,21,6,0,0,0,0,0,0,0,0,0,1,3,0,6
1030,75,535,182,353,1,352,8,344,127,87,44,53,10,7,0,6,0,0,1,0,1,0,0,0,4,0,4
1031,75,492,185,307,5,302,3,299,109,70,49,34,18,11,1,0,0,0,0,0,0,0,0,0,4,0,3
1032,75,534,146,388,2,386,6,380,145,90,56,58,12,6,0,0,0,0,0,3,0,0,0,0,3,0,7
1033,75,539,161,378,0,378,2,376,145,95,51,51,17,9,0,0,0,0,0,0,0,2,0,1,1,0,4
1034,75,554,199,355,2,353,1,352,142,87,38,47,19,10,0,1,0,0,0,0,0,2,0,0,1,0,5
1035,75,620,189,431,1,430,3,427,178,109,44,54,18,8,0,2,0,0,1,0,0,0,0,0,4,0,9
1036,75,868,228,640,3,637,7,630,307,100,75,91,18,18,0,3,0,1,0,1,0,0,0,0,3,1,12
1037,75,526,144,382,4,378,9,369,165,78,63,44,5,4,0,1,0,3,0,0,0,0,0,0,1,0,5
1038,75,526,133,393,2,391,6,385,171,94,53,40,7,7,0,0,0,0,0,0,0,0,0,0,3,0,10
1039,75,860,190,670,2,668,5,663,326,124,58,92,19,9,0,0,0,0,0,0,0,1,0,2,5,1,26
1040,75,741,215,526,6,520,2,518,216,118,67,63,25,9,0,0,1,0,0,0,1,1,0,0,2,2,13
1041,75,529,133,396,2,394,4,390,175,91,41,52,12,8,0,0,0,0,0,0,0,0,0,0,2,0,9
1042,75,541,165,376,0,376,2,374,187,82,38,35,11,8,0,0,1,0,0,0,0,0,1,0,2,0,9
1043,75,835,267,568,2,566,10,556,195,142,92,77,21,12,0,2,0,0,0,1,1,0,0,0,5,1,7
1044,75,532,141,391,2,389,4,385,171,84,45,55,16,4,0,0,0,0,0,0,0,0,0,0,0,0,10
1045,75,519,129,390,5,385,5,380,199,61,43,50,9,6,0,2,0,0,0,0,0,0,0,0,1,0,9
1046,75,520,134,386,2,384,5,379,173,90,35,50,12,5,0,0,0,0,0,2,0,0,0,0,2,1,9
1047,75,549,174,375,3,372,4,368,166,81,50,45,9,6,1,0,1,0,0,1,0,0,1,0,3,0,4
1048,75,779,230,549,3,546,6,540,290,80,41,73,25,10,0,2,0,0,0,0,0,0,2,0,1,0,16
1049,75,789,207,582,2,580,11,569,273,121,58,68,19,8,0,0,0,0,0,2,1,1,0,1,1,0,16
1050,75,602,155,447,0,447,4,443,226,84,37,74,9,6,0,0,0,0,0,0,0,0,0,0,0,0,7
1051,75,561,131,430,2,428,2,426,216,81,49,54,8,5,0,0,1,0,0,1,0,0,0,0,2,1,8
1052,75,865,209,656,4,652,3,649,357,102,52,74,12,13,0,2,0,0,1,3,0,0,0,2,0,1,30
1053,75,500,189,311,2,309,1,308,111,93,44,32,13,4,0,0,0,0,0,1,0,0,1,1,1,0,7
1054,75,514,169,345,0,345,6,339,137,85,54,27,15,8,1,1,0,0,0,0,0,0,2,0,2,0,7
1055,76,587,184,403,2,401,11,390,147,89,60,55,19,10,0,2,0,0,0,0,0,0,0,1,1,0,6
1056,76,557,163,394,2,392,8,384,166,83,53,49,12,6,0,1,0,0,1,0,1,1,0,1,1,0,9
1057,76,549,140,409,1,408,5,403,172,74,54,55,15,13,0,0,0,0,1,0,0,2,0,3,1,0,13
1058,76,496,143,353,2,351,2,349,134,75,45,61,11,9,0,0,1,0,1,0,0,0,0,1,1,0,10
1059,76,918,190,728,3,725,8,717,321,152,71,98,31,14,1,2,1,0,0,0,0,0,0,2,5,0,19
1060,76,698,136,562,4,558,6,552,297,96,39,89,9,9,0,0,0,0,0,1,0,0,0,0,2,0,10
1061,76,696,167,529,2,527,2,525,281,80,40,82,7,8,1,0,0,0,1,0,0,0,0,0,6,1,18
1062,76,907,235,672,4,668,6,662,311,138,84,76,27,8,2,0,0,0,0,0,0,1,1,0,2,0,12
1063,76,929,201,728,5,723,3,720,359,143,69,80,27,12,1,0,0,0,1,2,1,0,0,1,2,0,22
1064,76,563,135,428,3,425,8,417,206,71,46,55,11,9,0,4,0,0,0,0,0,0,0,1,7,0,7
1065,76,823,173,650,4,646,6,640,398,84,25,72,11,15,1,2,1,0,0,0,0,0,0,1,4,0,26
1066,76,882,203,679,6,673,6,667,390,81,43,86,9,6,0,0,0,0,0,1,0,0,0,2,2,0,47
1067,76,587,149,438,2,436,3,433,217,98,38,46,11,7,0,0,0,0,1,0,0,0,0,0,0,0,15
1068,76,614,158,456,2,454,8,446,243,66,43,62,14,4,0,0,0,0,0,1,0,1,0,0,2,0,10
1069,76,643,138,505,1,504,3,501,310,68,28,50,10,9,0,2,0,0,0,0,0,0,0,2,2,0,20
1070,76,720,164,556,0,556,7,549,335,91,34,60,3,4,0,1,0,1,1,0,0,0,0,0,5,0,14
1071,76,813,152,661,1,660,4,656,419,81,18,87,11,7,0,0,0,0,1,0,0,0,0,1,1,0,30
1072,76,486,89,397,0,397,2,395,286,39,11,29,5,6,0,1,0,0,0,0,0,0,0,1,1,5,11
1073,76,533,115,418,4,414,2,412,293,38,13,43,6,2,0,1,0,0,0,1,0,0,0,1,3,0,11
1074,76,948,241,707,1,706,5,701,462,81,34,69,6,10,0,0,0,0,0,0,0,0,0,1,1,0,37
1075,76,958,207,751,4,747,6,741,464,85,47,96,9,18,0,1,0,0,1,1,0,0,0,0,1,1,17
1076,76,552,168,384,1,383,3,380,251,18,10,65,10,6,1,0,1,0,0,1,0,0,0,0,2,0,15
1077,76,903,264,639,3,636,6,630,317,113,56,87,11,13,1,1,0,0,0,0,3,0,2,0,3,0,23
1078,81,718,202,516,4,512,3,509,299,48,69,61,6,10,1,0,0,0,1,1,0,1,0,2,6,1,3
1079,81,603,239,364,3,361,2,359,187,63,42,42,11,4,0,0,0,0,0,0,0,0,0,0,2,2,6
1080,81,1004,318,686,8,678,8,670,318,133,81,83,8,17,2,0,0,0,1,3,0,0,0,1,11,0,12
1081,81,635,243,392,9,383,5,378,156,80,43,64,12,5,0,0,0,1,0,1,0,0,1,1,11,2,1
1082,82,749,205,544,1,543,5,538,379,61,13,56,6,7,0,0,0,0,0,0,0,0,0,0,1,0,15
1083,82,762,172,590,2,588,8,580,392,63,28,69,3,7,0,2,0,0,0,0,0,1,0,0,1,1,13
1084,82,914,191,723,1,722,4,718,507,59,30,90,4,5,0,1,0,1,0,0,0,0,0,1,3,0,17
1085,83,511,139,372,3,369,3,366,183,79,37,46,3,5,0,1,0,0,0,0,0,1,0,0,4,0,7
1086,83,561,146,415,4,411,3,408,203,69,51,54,11,7,1,0,0,0,0,0,0,0,0,1,2,1,8
1087,83,633,205,428,2,426,2,424,187,93,53,50,12,11,0,3,0,0,0,1,1,0,0,0,7,1,5
1088,83,690,223,467,1,466,1,465,170,131,56,67,15,13,1,0,0,0,0,0,1,0,0,0,2,3,6
1089,83,695,195,500,5,495,6,489,195,130,72,38,11,14,0,1,0,0,1,0,1,1,0,0,10,1,14
1090,83,570,181,389,1,388,2,386,122,119,66,42,22,6,0,0,0,0,0,0,0,0,0,1,6,1,1
1091,83,508,131,377,5,372,4,368,162,89,37,52,15,7,0,0,0,0,0,1,0,1,1,0,1,0,2
1092,83,519,151,368,2,366,3,363,141,107,46,52,3,4,0,1,0,0,0,0,0,1,0,0,2,1,5
1093,83,488,111,377,1,376,3,373,211,49,39,53,6,9,1,0,0,1,0,0,0,0,0,0,0,0,4
1094,83,768,191,577,1,576,6,570,310,97,48,68,17,14,0,1,0,0,1,0,0,0,0,0,5,0,9
1095,83,692,154,538,7,531,6,525,269,96,51,65,12,8,0,1,0,0,0,0,0,0,1,0,5,0,17
1096,83,615,129,486,2,484,6,478,139,164,85,53,20,9,0,0,0,0,0,0,2,0,0,0,2,0,4
1097,83,844,209,635,3,632,7,625,222,190,106,70,17,6,0,0,0,0,0,1,1,2,0,2,4,0,4
1098,83,664,228,436,3,433,3,430,116,170,79,34,13,7,0,0,1,1,0,1,0,1,0,3,3,1,0
1099,83,695,216,479,2,477,7,470,145,139,78,63,25,7,0,1,0,2,0,0,0,0,1,3,1,1,4
1100,83,675,179,496,0,496,3,493,138,167,72,74,20,9,1,1,1,0,0,1,0,1,0,2,4,0,2
1101,83,649,208,441,1,440,5,435,108,156,98,38,19,8,1,0,0,0,0,0,0,2,0,2,1,1,1
1102,83,677,214,463,3,460,7,453,141,160,83,36,15,7,0,0,0,0,0,0,0,0,1,0,4,4,2
1103,83,712,203,509,4,505,6,499,198,120,83,58,14,9,2,0,0,0,0,0,0,0,0,0,10,0,5
1104,83,805,236,569,4,565,3,562,218,146,81,62,24,12,1,0,0,1,0,2,1,1,0,3,4,0,6
1105,83,786,247,539,2,537,0,537,184,158,75,86,16,8,0,1,0,0,0,2,0,0,0,0,2,0,5
1106,83,795,262,533,4,529,7,522,201,149,67,64,17,8,1,0,0,0,0,2,0,3,0,0,6,1,3
1107,83,769,190,579,2,577,4,573,170,179,82,84,26,8,0,0,0,0,1,3,0,1,1,3,6,0,9
1108,83,814,202,612,6,606,7,599,204,167,88,79,33,9,0,2,0,0,0,2,0,1,1,1,5,3,4
1109,83,716,199,517,5,512,10,502,162,157,80,65,15,10,0,0,0,1,0,0,0,2,0,1,4,1,4
1110,83,594,163,431,2,429,5,424,135,128,68,53,15,13,0,0,1,1,0,0,0,0,1,0,1,1,7
1111,83,572,151,421,8,413,1,412,152,120,66,46,15,4,0,0,0,1,0,0,0,1,0,1,3,1,2
1112,83,535,169,366,4,362,2,360,142,93,52,42,13,7,0,2,0,1,0,0,0,0,0,0,4,0,4
1113,83,579,150,429,6,423,3,420,159,114,68,41,17,10,1,1,0,0,0,0,0,0,0,4,4,0,1
1114,83,949,216,733,9,724,8,716,311,167,83,98,21,19,0,0,0,0,0,2,0,0,2,1,4,0,8
1115,83,589,130,459,4,455,3,452,192,102,51,69,20,8,0,0,0,0,0,0,0,1,0,0,3,1,5
1116,83,625,129,496,4,492,7,485,188,131,69,53,21,7,0,0,0,1,0,1,0,1,0,0,5,2,6
1117,83,779,188,591,2,589,9,580,221,150,67,107,12,11,0,0,1,0,0,0,1,1,0,0,1,1,7
1118,83,836,198,638,2,636,6,630,241,154,72,111,20,15,0,1,0,0,0,0,1,3,0,1,5,1,5
1119,83,770,260,510,2,508,3,505,160,145,96,66,20,12,0,0,0,0,0,0,0,0,0,0,2,1,3
1120,83,801,257,544,7,537,7,530,167,175,84,56,22,10,0,0,0,0,0,0,0,0,0,4,5,1,6
1121,83,615,134,481,2,479,4,475,171,143,73,49,26,5,0,1,0,0,0,0,0,1,0,0,1,1,4
1122,83,578,126,452,1,451,1,450,164,130,60,59,18,11,1,0,0,0,0,0,0,0,1,1,3,0,2
1123,83,711,212,499,4,495,8,487,164,121,78,74,26,9,2,0,0,0,0,0,0,1,1,1,7,0,3
1124,83,698,201,497,1,496,9,487,158,147,71,72,15,16,0,0,0,0,0,0,0,2,2,0,2,0,2
1125,83,751,199,552,7,545,8,537,160,199,101,39,21,9,0,1,0,0,0,0,0,1,1,1,4,0,0
1126,83,894,190,704,8,696,11,685,242,198,101,82,23,18,0,1,0,0,0,0,0,0,0,1,5,0,14
1127,83,560,151,409,1,408,6,402,123,133,60,53,17,6,0,0,0,1,0,1,0,1,0,1,3,0,3
1128,83,505,176,329,2,327,6,321,104,95,48,38,12,12,1,2,0,0,0,0,0,0,1,1,3,1,3
1129,83,508,113,395,3,392,1,391,217,74,31,50,8,5,0,0,0,0,0,1,0,0,0,1,0,0,4
1130,83,512,105,407,2,405,4,401,200,83,40,47,12,10,0,0,0,0,0,0,0,0,0,1,2,0,6
1131,83,555,104,451,5,446,7,439,175,110,49,62,14,15,0,1,0,0,2,0,0,0,1,0,6,0,4
1132,83,531,127,404,1,403,1,402,171,100,52,55,8,9,0,0,0,0,0,0,0,0,0,0,3,0,4
1133,83,811,164,647,0,647,1,646,249,144,83,115,22,12,0,2,0,0,0,1,0,0,1,1,12,0,4
1134,83,830,178,652,7,645,11,634,228,167,87,92,29,13,1,0,0,0,0,1,0,1,0,0,3,3,9
1135,83,692,186,506,7,499,4,495,198,147,72,46,14,7,0,0,0,0,0,0,1,1,1,0,3,1,4
1136,83,783,175,608,5,603,6,597,191,157,109,77,31,12,0,0,0,0,0,0,0,0,6,0,6,0,8
1137,83,616,161,455,7,448,6,442,182,95,54,63,16,11,1,0,0,0,2,0,0,0,0,1,3,1,13
1138,84,670,175,495,5,490,5,485,221,112,68,48,14,7,0,0,0,0,0,0,0,0,0,1,1,1,12
1139,84,617,138,479,5,474,7,467,210,130,39,46,14,7,0,0,0,1,2,2,0,0,0,0,4,0,12
1140,84,625,131,494,4,490,6,484,227,111,53,44,12,13,1,4,1,0,0,0,0,0,0,0,2,1,15
1141,84,628,153,475,0,475,9,466,210,103,63,47,20,11,0,1,0,0,0,0,1,0,0,1,2,0,7
1142,84,565,137,428,3,425,2,423,168,112,48,39,30,12,0,0,0,1,0,0,0,0,0,0,5,2,6
1143,84,885,169,716,6,710,7,703,305,160,78,88,27,16,0,0,0,0,1,0,1,1,0,2,8,0,16
1144,84,703,135,568,6,562,7,555,271,113,68,61,13,10,0,1,0,0,0,1,1,1,0,0,5,10,0
1145,84,699,145,554,3,551,4,547,247,118,58,67,19,10,0,3,0,0,0,0,0,0,0,1,7,1,16
1146,84,781,266,515,3,512,6,506,180,162,74,48,22,13,0,0,0,0,0,1,0,2,0,1,2,0,1
1147,84,884,273,611,5,606,14,592,175,203,108,55,22,16,0,0,0,0,0,2,0,0,2,3,3,0,3
1148,84,491,179,312,4,308,6,302,98,96,49,37,10,4,0,0,0,0,0,0,0,0,0,2,6,0,0
1149,84,537,180,357,3,354,2,352,100,103,86,26,21,5,0,1,0,2,0,0,0,1,0,0,5,0,2
1150,84,865,305,560,4,556,9,547,175,161,102,54,19,13,1,1,0,0,0,0,0,1,0,1,11,0,8
1151,84,890,311,579,8,571,8,563,137,214,104,52,27,11,0,0,1,0,0,0,0,0,0,3,11,0,3
1152,84,986,263,723,3,720,4,716,297,200,90,69,24,15,0,0,0,0,0,0,0,0,2,2,7,0,10
1153,84,685,153,532,2,530,6,524,214,149,67,57,12,12,0,0,0,0,0,1,1,0,1,0,3,0,7
1154,84,634,142,492,9,483,7,476,177,124,96,53,9,5,0,0,0,0,0,0,0,0,1,2,2,0,7
1155,84,526,115,411,3,408,1,407,200,78,43,49,16,4,0,1,0,0,0,0,1,1,0,1,5,0,8
1156,84,519,100,419,2,417,5,412,182,86,45,49,15,14,1,2,0,0,1,1,0,0,0,0,2,1,13
1157,84,968,245,723,3,720,6,714,346,141,80,103,10,8,0,0,0,1,0,0,0,1,1,1,4,0,18
1158,84,753,167,586,2,584,11,573,248,144,74,67,17,8,0,0,0,0,0,0,0,0,0,2,5,3,5
1159,84,824,172,652,0,652,7,645,268,141,84,78,22,25,0,2,0,0,0,0,0,1,0,0,3,0,21
1160,84,578,147,431,6,425,9,416,198,86,47,43,13,9,0,0,0,0,0,1,0,0,0,0,7,0,12
1161,84,614,133,481,1,480,5,475,241,102,50,43,16,6,0,0,0,0,1,0,1,0,1,0,2,1,11
1162,84,769,273,496,2,494,5,489,121,142,123,53,33,8,0,0,0,0,0,0,0,0,0,1,6,0,2
1163,84,574,204,370,4,366,10,356,98,122,55,43,21,5,0,0,0,0,0,0,0,0,1,2,6,0,3
1164,84,627,233,394,1,393,2,391,116,131,83,28,15,3,0,0,0,1,1,0,0,4,0,2,5,2,0
1165,84,949,340,609,6,603,6,597,166,214,117,44,29,9,0,1,0,2,1,0,0,2,0,3,7,1,1
1166,84,759,268,491,2,489,6,483,136,153,119,41,12,8,0,0,0,1,0,6,1,2,2,0,2,0,0
1167,84,606,226,380,5,375,14,361,96,129,69,36,10,9,2,0,0,0,0,1,1,1,1,0,4,0,2
1168,84,564,204,360,6,354,1,353,103,112,64,41,19,4,0,0,0,0,3,0,1,0,0,1,1,0,4
1169,84,601,218,383,6,377,4,373,102,130,72,30,18,9,0,0,0,0,1,1,1,1,0,0,7,0,1
1170,84,784,281,503,4,499,9,490,130,161,100,64,13,16,0,0,0,0,0,0,0,0,1,0,3,0,2
1171,84,686,255,431,2,429,5,424,131,135,91,36,17,6,0,1,0,1,0,0,0,0,0,1,2,1,2
1172,84,802,258,544,2,542,4,538,194,143,98,60,25,10,0,0,0,0,0,1,0,1,0,0,3,2,1
1173,84,761,251,510,2,508,1,507,186,142,73,59,26,12,0,0,0,0,0,0,0,0,0,0,7,1,1
1174,84,718,240,478,8,470,5,465,168,144,82,50,12,4,0,0,0,0,0,0,0,0,0,0,4,0,1
1175,84,723,235,488,6,482,4,478,171,156,84,31,14,12,2,0,0,0,1,0,0,0,0,1,4,0,2
1176,84,719,260,459,7,452,3,449,154,155,79,36,16,0,1,2,0,0,0,0,0,1,0,1,1,0,3
1177,84,682,279,403,2,401,3,398,137,103,78,34,24,10,1,0,0,0,0,0,1,0,1,0,6,0,3
1178,84,763,276,487,6,481,2,479,163,154,84,38,17,9,0,0,0,0,0,0,0,0,0,0,9,2,3
1179,84,665,253,412,5,407,3,404,150,99,82,38,20,5,0,0,0,0,0,2,0,0,0,0,4,0,4
1180,84,838,292,546,1,545,19,526,165,181,84,42,33,11,0,0,0,0,0,2,0,0,0,0,1,1,6
1181,84,734,300,434,4,430,4,426,157,123,65,50,15,4,1,0,0,1,1,0,0,1,0,0,5,0,3
1182,84,784,288,496,3,493,2,491,182,143,90,40,13,12,0,0,0,0,0,0,0,1,0,1,6,1,2
1183,84,763,291,472,2,470,1,469,130,180,84,46,14,7,0,0,0,0,0,0,0,0,0,0,6,0,2
1184,84,805,311,494,3,491,2,489,147,157,101,35,23,12,0,0,0,3,0,0,0,1,1,3,3,1,2
1185,84,718,303,415,3,412,5,407,113,140,88,31,14,8,1,1,0,0,2,1,1,1,0,1,3,2,0
1186,84,668,236,432,3,429,4,425,110,136,104,31,22,8,0,0,0,0,0,0,0,1,2,1,9,0,1
1187,84,678,223,455,0,455,1,454,148,138,88,37,23,10,0,0,1,0,0,0,0,0,1,0,5,0,3
1188,84,563,213,350,2,348,1,347,117,115,68,25,10,6,0,0,0,0,1,0,0,1,1,1,2,0,0
1189,84,617,194,423,4,419,5,414,115,118,104,42,21,6,0,0,0,0,0,0,0,0,2,0,1,0,5
1190,84,571,175,396,2,394,4,390,132,127,70,23,10,12,0,1,0,0,1,1,0,1,2,2,5,0,3
1191,85,580,100,480,4,476,7,469,252,91,26,73,9,4,0,0,0,0,0,0,0,0,0,1,1,1,11
1192,85,618,132,486,2,484,5,479,246,93,37,70,11,10,0,0,0,0,0,0,0,0,1,0,2,0,9
1193,85,678,163,515,2,513,7,506,233,108,50,62,17,18,0,0,0,0,1,0,0,0,1,1,3,1,11
1194,85,696,153,543,3,540,6,534,228,119,60,77,18,10,1,1,0,0,0,2,0,0,0,1,0,2,15
1195,85,755,148,607,3,604,6,598,214,170,69,92,17,19,0,0,0,0,0,0,1,0,1,0,4,0,11
1196,85,737,186,551,5,546,4,542,297,96,36,60,15,20,0,4,0,0,0,0,0,0,0,0,2,0,12
1197,85,916,225,691,2,689,6,683,332,158,70,88,10,10,0,0,0,0,1,0,0,0,0,0,3,0,11
1198,85,996,248,748,4,744,10,734,322,187,89,100,0,14,1,0,0,0,0,2,0,0,0,2,8,0,9
1199,85,638,168,470,1,469,5,464,167,139,74,44,19,10,0,0,0,0,0,1,0,1,0,0,7,0,2
1200,85,619,165,454,4,450,5,445,166,138,67,40,13,7,0,0,0,0,1,0,0,4,0,0,3,0,6
1201,85,619,158,461,5,456,6,450,163,154,57,43,12,8,0,0,0,0,0,2,0,1,0,0,3,0,7
1202,85,607,128,479,4,475,4,471,199,113,59,57,15,9,1,0,0,0,0,0,0,2,0,0,3,0,13
1203,85,617,135,482,2,480,6,474,210,111,55,64,14,6,1,0,0,0,0,0,1,0,0,1,0,2,9
1204,85,737,184,553,2,551,3,548,280,90,72,52,19,15,2,0,0,0,0,0,3,0,0,0,0,1,14
1205,85,719,155,564,3,561,7,554,206,142,67,92,16,11,1,0,0,0,1,0,0,0,0,0,5,3,10
1206,85,541,100,441,3,438,1,437,186,120,58,54,3,5,0,0,0,0,0,1,0,1,1,0,2,0,6
1207,85,536,103,433,2,431,5,426,193,105,59,45,5,10,0,1,0,0,0,3,0,0,0,0,2,0,3
1208,85,659,200,459,6,453,3,450,160,129,64,52,19,12,2,2,0,0,0,1,0,0,1,1,4,0,3
1209,85,827,264,563,9,554,7,547,183,176,96,48,21,7,0,0,0,0,0,1,0,4,0,1,2,1,7
1210,85,827,229,598,4,594,7,587,257,140,87,44,18,13,0,2,0,0,0,3,0,1,0,1,2,1,18
1211,85,973,241,732,2,730,7,723,293,179,119,75,21,11,0,0,0,0,2,2,2,0,0,0,6,0,13
1212,85,704,141,563,3,560,1,559,241,150,41,84,15,9,0,0,0,0,1,0,0,1,0,0,3,0,14
1213,85,746,156,590,3,587,11,576,218,173,60,84,13,12,1,2,0,0,0,0,1,0,0,0,1,0,11
1214,85,713,129,584,5,579,10,569,229,159,60,89,12,6,0,2,0,0,1,1,0,0,0,0,2,0,8
1215,85,675,129,546,4,542,6,536,236,170,43,61,14,4,0,0,1,0,0,0,0,0,0,0,1,0,6
1216,85,728,157,571,6,565,4,561,229,133,68,78,21,18,0,0,0,0,0,0,0,0,0,0,4,0,10
1217,85,808,166,642,0,642,6,636,316,112,75,89,11,12,1,1,0,0,0,0,0,0,1,0,3,0,15
1218,85,705,175,530,4,526,6,520,236,101,53,72,15,17,0,1,0,0,0,0,0,0,0,2,3,0,20
1219,85,662,134,528,2,526,6,520,201,157,60,66,13,10,0,0,0,0,1,0,0,0,0,0,6,0,6
1220,85,671,162,509,1,508,7,501,189,125,63,84,19,8,0,0,0,0,0,0,0,0,0,0,3,0,10
1221,85,538,103,435,0,435,2,433,201,99,26,84,6,8,0,0,0,0,0,1,1,0,0,0,3,1,3
1222,85,626,138,488,2,486,2,484,232,121,43,72,4,5,0,0,0,0,0,0,0,0,1,0,4,0,2
1223,85,899,191,708,5,703,11,692,302,147,72,106,16,15,0,1,0,0,0,0,0,0,1,1,5,0,26
1224,85,916,212,704,6,698,3,695,302,173,67,92,20,20,0,2,0,1,0,3,0,0,0,0,4,0,11
1225,85,558,143,415,1,414,9,405,229,52,20,68,9,8,0,0,0,1,0,0,0,0,0,0,0,0,18
1226,85,617,146,471,2,469,8,461,286,67,23,59,4,9,0,0,0,0,0,0,0,0,0,2,2,0,9
1227,85,712,156,556,6,550,4,546,270,110,47,83,14,7,0,1,0,0,0,0,0,0,0,0,5,0,9
1228,85,650,124,526,3,523,6,517,229,118,35,99,13,13,0,0,0,0,0,0,0,0,1,1,1,1,6
1229,85,698,157,541,5,536,6,530,250,116,38,74,8,14,0,0,0,0,0,0,0,0,0,0,13,0,17
1230,85,645,128,517,5,512,5,507,234,129,53,58,10,10,0,0,0,0,0,1,0,0,0,1,2,1,8
1231,85,535,131,404,0,404,4,400,248,60,20,54,3,7,1,0,0,0,0,0,0,0,0,0,0,0,7
1232,85,535,122,413,3,410,3,407,252,56,17,59,3,5,1,0,0,0,0,0,0,0,0,1,4,0,9
1233,86,883,348,535,16,519,0,519,176,138,106,51,15,14,0,1,1,1,1,1,0,0,1,1,5,0,7
1234,86,580,223,357,0,357,7,350,128,90,70,27,12,13,0,1,0,1,0,0,0,0,0,0,4,0,4
1235,86,673,297,376,4,372,6,366,115,109,74,41,15,9,0,0,0,0,0,0,0,0,0,0,3,0,0
1236,86,553,193,360,7,353,3,350,115,93,80,30,14,8,0,0,0,0,0,0,0,0,1,0,7,0,2
1237,86,576,190,386,4,382,10,372,128,109,58,37,21,9,0,0,0,0,0,0,1,0,1,1,6,0,1
1238,86,919,329,590,6,584,2,582,205,170,116,45,20,9,0,1,0,0,0,3,0,1,1,0,4,0,7
1239,86,904,255,649,10,639,6,633,284,152,75,63,29,11,0,0,0,0,0,3,0,0,0,0,9,0,7
1240,86,648,149,499,3,496,2,494,208,126,53,55,18,21,0,0,0,0,0,0,0,0,0,3,2,0,8
1241,86,623,157,466,2,464,6,458,212,127,48,39,12,7,1,1,1,0,0,0,0,0,0,0,3,0,7
1242,86,898,429,469,8,461,0,461,118,158,77,44,37,5,0,0,0,0,1,1,0,1,1,3,7,4,4
1243,86,718,258,460,3,457,5,452,156,140,55,53,25,10,0,0,0,0,0,0,0,0,4,2,2,0,5
1244,86,662,315,347,6,341,3,338,71,112,81,36,18,6,0,0,0,0,0,2,0,3,2,1,4,0,2
1245,86,778,339,439,4,435,6,429,85,153,108,48,14,8,0,1,0,0,3,0,0,1,0,2,4,1,1
1246,86,595,214,381,2,379,7,372,72,153,64,33,22,10,0,2,0,0,0,0,0,1,0,1,11,1,2
1247,86,667,231,436,4,432,6,426,130,132,93,31,24,9,0,0,0,0,0,2,0,0,0,0,1,1,3
1248,86,587,199,388,2,386,2,384,111,115,81,40,18,8,1,0,0,0,0,0,0,0,1,0,2,0,7
1249,86,600,218,382,3,379,4,375,102,97,92,44,21,5,1,0,0,0,1,1,1,0,0,0,9,0,1
1250,86,735,243,492,6,486,3,483,136,158,95,39,33,10,0,0,2,0,0,0,0,1,0,0,6,0,3
1251,86,623,268,355,3,352,3,349,74,108,89,36,17,8,2,0,0,0,0,1,0,0,0,5,5,0,4
1252,86,610,256,354,3,351,3,348,75,122,75,42,18,7,0,0,0,1,0,0,0,0,0,1,6,0,1
1253,86,755,323,432,4,428,3,425,87,153,95,33,38,11,0,0,0,0,0,0,0,1,2,0,4,1,0
1254,86,941,352,589,5,584,9,575,195,137,139,48,21,12,0,1,0,0,0,0,0,1,0,2,11,1,7
1255,86,617,241,376,2,374,1,373,105,112,72,32,25,8,1,1,1,2,1,0,0,3,3,1,3,0,3
1256,86,643,213,430,4,426,3,423,119,125,80,46,18,12,2,0,0,1,0,0,0,1,1,2,8,1,7
1257,86,831,346,485,5,480,6,474,136,134,100,52,24,7,0,0,0,0,1,3,2,0,1,0,6,0,8
1258,86,557,174,383,1,382,7,375,151,100,60,34,16,2,0,0,0,0,0,0,0,2,0,0,1,2,7
1259,86,534,159,375,1,374,4,370,128,100,61,37,20,8,0,0,0,0,0,1,2,2,1,0,5,0,5
1260,86,798,158,640,1,639,10,629,262,100,44,159,13,18,0,1,0,0,0,0,0,0,0,0,3,1,28
1261,86,732,143,589,3,586,13,573,234,104,47,146,14,12,0,3,0,0,0,0,0,0,0,0,2,0,11
1262,86,605,151,454,5,449,11,438,133,107,94,57,25,8,0,0,1,0,0,0,0,0,1,1,5,0,6
1263,86,640,149,491,5,486,7,479,141,141,95,71,10,9,0,0,0,0,0,0,0,0,0,0,6,1,5
1264,86,757,173,584,7,577,7,570,251,137,59,89,11,14,0,0,0,0,0,0,0,0,0,0,2,1,6
1265,86,733,154,579,3,576,9,567,228,121,66,103,23,11,0,1,0,0,0,0,0,0,0,1,2,0,11
1266,86,911,210,701,1,700,11,689,231,132,91,179,14,20,0,1,0,1,1,0,0,0,1,2,2,2,12
1267,86,1030,235,795,6,789,11,778,306,130,94,194,18,16,1,1,0,0,0,0,0,0,1,2,1,0,14
1268,86,608,139,469,4,465,6,459,181,89,42,117,7,13,1,0,0,1,0,0,1,0,0,0,1,0,6
1269,86,754,160,594,1,593,9,584,253,102,62,135,6,18,0,0,0,0,0,0,0,0,0,1,1,0,6
1270,86,681,152,529,0,529,8,521,191,82,59,156,7,12,0,0,0,0,1,1,1,0,0,0,2,0,9
1271,86,504,112,392,6,386,4,382,120,90,71,73,16,7,0,0,0,0,0,0,0,0,0,0,4,0,1
1272,86,514,116,398,5,393,6,387,124,86,44,78,17,19,0,0,0,0,0,1,0,2,0,0,5,1,10
1273,86,793,271,522,6,516,12,504,166,116,98,77,17,15,0,0,0,1,1,0,1,0,0,5,1,0,6
1274,86,865,168,697,7,690,8,682,367,69,37,162,15,12,0,2,0,0,0,0,0,0,1,0,0,0,17
1275,86,873,187,686,2,684,1,683,341,75,33,191,6,11,0,1,0,0,2,0,0,0,0,0,1,0,22
1276,86,937,215,722,5,717,10,707,177,159,118,161,36,34,0,3,0,1,0,0,0,0,0,1,6,0,11
1277,86,1016,243,773,7,766,8,758,203,162,141,163,34,34,0,0,0,0,0,0,1,0,0,1,8,0,11
1278,86,715,156,559,1,558,15,543,213,72,64,134,12,16,0,3,0,0,1,0,0,0,0,0,2,0,26
1279,86,791,160,631,3,628,10,618,263,77,64,160,14,15,0,1,0,0,1,0,0,0,1,0,1,0,21
1280,86,905,182,723,5,718,4,714,281,131,85,175,9,12,1,0,0,0,0,0,0,0,1,2,2,1,14
1281,86,974,230,744,2,742,8,734,305,116,88,163,12,27,0,0,0,0,0,0,0,0,1,2,1,0,19
1282,86,648,172,476,3,473,9,464,155,101,52,119,13,11,0,0,0,0,0,1,0,0,0,1,4,1,6
1283,86,601,143,458,7,451,4,447,136,92,83,92,14,12,0,0,0,1,0,0,0,0,0,3,5,0,9
1284,86,536,121,415,3,412,9,403,132,85,38,99,19,12,1,2,0,0,0,0,0,2,0,1,0,4,8
1285,86,591,141,450,0,450,6,444,137,106,53,119,10,8,0,0,0,0,0,0,0,1,0,0,2,2,6
1286,86,836,225,611,3,608,9,599,168,109,122,134,32,15,0,0,0,0,1,0,0,0,1,1,4,1,11
1287,87,958,245,713,1,712,11,701,289,114,73,161,22,14,1,1,0,0,0,0,0,0,0,2,4,1,19
1288,87,976,235,741,2,739,15,724,299,117,76,181,10,14,0,1,0,0,0,1,0,0,0,0,3,0,22
1289,87,649,150,499,0,499,3,496,317,57,17,58,8,3,0,0,0,0,0,0,0,0,0,0,0,0,36
1290,87,586,141,445,1,444,6,438,234,77,26,55,16,7,0,0,0,0,0,0,1,0,0,0,0,0,22
1291,87,519,115,404,1,403,10,393,277,39,9,31,4,2,0,1,0,0,0,0,0,1,0,0,1,0,28
1292,87,478,136,342,0,342,1,341,244,26,10,32,4,3,0,0,0,0,0,0,0,0,0,0,3,0,19
1293,87,814,227,587,2,585,3,582,326,84,29,102,5,6,0,0,0,0,2,0,0,0,0,0,2,2,24
1294,87,863,193,670,3,667,7,660,403,74,31,103,10,8,0,3,0,0,0,1,0,0,0,0,2,0,25
1295,87,554,154,400,4,396,3,393,175,103,41,45,14,7,0,0,0,0,0,0,0,0,1,0,1,0,6
1296,87,522,127,395,1,394,4,390,168,112,36,44,15,5,0,0,0,0,0,0,1,0,0,0,0,0,9
1297,87,619,149,470,0,470,7,463,309,57,7,58,10,1,0,4,0,0,0,0,0,1,0,0,1,0,15
1298,87,592,118,474,2,472,12,460,296,52,8,63,4,3,1,1,0,0,1,2,0,0,0,2,1,0,26
1299,87,833,216,617,2,615,9,606,417,57,18,70,6,7,0,2,0,0,1,0,1,0,0,0,4,1,22
1300,87,537,200,337,1,336,3,333,166,52,34,50,8,11,0,0,0,0,0,0,0,1,0,0,4,0,7
1301,87,502,144,358,4,354,3,351,130,77,43,56,11,14,0,0,0,0,1,0,0,0,1,0,3,0,15
1302,87,587,136,451,2,449,11,438,249,58,18,72,4,7,0,1,0,0,0,1,0,0,0,0,2,0,26
1303,87,592,133,459,3,456,7,449,265,63,15,60,6,11,0,2,0,0,0,2,0,0,0,1,0,0,24
1304,87,650,121,529,0,529,4,525,363,33,10,84,2,5,0,0,0,0,0,0,0,0,0,0,2,1,25
1305,87,593,110,483,1,482,4,478,299,56,15,69,3,8,0,1,0,0,1,0,0,0,0,0,0,0,26
1306,87,595,131,464,3,461,7,454,237,64,45,68,8,7,0,1,0,0,0,0,0,0,0,0,1,0,23
1307,87,613,126,487,3,484,4,480,241,89,19,85,9,21,0,1,0,0,1,0,0,0,0,0,3,1,10
1308,87,570,109,461,2,459,0,459,116,151,86,70,13,13,0,0,0,0,0,1,1,0,0,1,3,0,4
1309,87,515,110,405,6,399,1,398,114,124,67,52,14,12,0,0,0,0,0,1,0,0,0,0,1,0,13
1310,87,566,151,415,1,414,1,413,131,115,58,65,22,10,0,0,0,0,0,0,0,0,0,0,3,0,9
1311,87,616,144,472,2,470,3,467,128,143,82,82,13,9,0,0,0,0,0,2,1,0,0,0,3,2,2
1312,87,542,114,428,1,427,3,424,269,42,24,63,5,5,0,0,0,0,0,1,0,1,0,0,0,0,14
1313,87,592,120,472,0,472,14,458,268,66,26,59,12,5,0,8,0,0,1,0,0,0,0,0,2,0,11
1314,87,712,134,578,6,572,10,562,190,151,73,96,23,12,0,2,0,0,0,2,1,1,0,0,1,1,9
1315,87,754,134,620,3,617,10,607,220,151,66,107,25,18,1,0,0,0,0,0,0,1,0,0,7,0,11
1316,87,747,171,576,2,574,13,561,340,63,17,92,4,7,0,1,0,0,0,2,0,1,0,1,1,0,32
1317,87,516,110,406,1,405,1,404,123,101,82,58,8,17,0,1,0,0,1,0,1,2,0,0,4,1,5
1318,87,507,103,404,5,399,10,389,103,116,65,69,19,9,0,3,0,2,0,0,0,0,0,0,1,1,1
1319,87,836,197,639,1,638,1,637,131,176,158,86,57,11,1,0,0,0,0,0,0,0,0,1,4,0,12
1320,88,833,576,257,1,256,4,252,144,71,10,13,5,4,0,0,1,0,0,0,0,0,0,0,0,0,4
1321,88,660,471,189,4,185,4,181,64,32,24,37,1,2,1,0,0,0,0,3,0,0,0,4,1,1,11
1322,88,779,167,612,2,610,13,597,249,99,74,123,16,9,0,1,0,1,0,1,1,0,0,1,3,0,19
1323,88,786,182,604,0,604,9,595,215,116,53,141,24,18,0,0,0,0,0,0,1,0,0,0,2,1,24
1324,88,916,174,742,2,740,20,720,337,101,71,144,18,17,0,3,0,0,1,1,0,0,1,0,2,1,23
1325,88,732,163,569,2,567,7,560,226,97,74,99,23,13,0,2,1,0,0,0,0,1,0,0,5,1,18
1326,88,801,173,628,0,628,12,616,245,102,80,119,15,26,1,1,0,0,0,1,0,0,0,0,2,0,24
1327,88,916,202,714,3,711,17,694,294,102,79,147,18,24,0,0,0,0,1,4,0,0,0,0,0,0,25
1328,88,1000,171,829,3,826,17,809,325,93,101,204,22,26,0,0,0,0,2,2,0,0,0,1,5,0,28
1329,88,761,130,631,2,629,8,621,315,79,45,142,10,6,0,5,0,0,0,1,0,0,0,0,0,0,18
1330,88,630,122,508,2,506,8,498,223,73,37,106,11,17,0,2,0,0,0,0,1,0,0,2,4,0,22
1331,88,603,123,480,2,478,6,472,193,93,36,103,11,10,1,0,1,0,1,0,0,0,1,0,4,0,18
1332,88,630,126,504,5,499,0,499,185,101,58,110,10,11,1,0,0,0,0,1,0,0,0,1,5,1,15
1333,91,985,301,684,9,675,7,668,237,152,127,70,40,23,2,1,0,0,0,1,1,2,1,0,1,0,10
1334,91,982,288,694,7,687,6,681,262,131,134,67,30,18,1,1,0,0,1,5,0,0,2,1,12,0,16
1335,91,613,151,462,4,458,1,457,148,115,104,46,14,9,1,0,0,0,0,1,0,1,0,0,6,1,11
1336,91,587,167,420,1,419,5,414,140,82,91,48,33,5,0,1,0,0,0,2,0,0,1,0,4,1,6
1337,91,673,202,471,2,469,2,467,153,142,98,28,22,10,2,0,0,0,0,0,0,0,0,0,4,2,6
1338,91,608,159,449,6,443,2,441,151,129,71,54,20,7,0,0,0,0,0,2,0,0,0,2,0,0,5
1339,91,761,194,567,5,562,3,559,184,122,127,53,31,9,1,0,0,0,0,0,0,0,2,1,7,1,21
1340,91,954,261,693,8,685,10,675,304,128,85,82,30,21,0,0,0,0,0,0,0,0,1,0,5,0,19
1341,91,849,255,594,10,584,5,579,216,140,113,51,25,8,0,0,0,0,1,0,0,1,0,2,6,1,15
1342,91,928,257,671,7,664,7,657,242,180,90,86,26,23,0,2,0,0,0,0,0,1,0,1,3,0,3
1343,91,998,268,730,6,724,8,716,245,206,105,93,25,16,0,1,0,0,0,0,1,0,0,1,10,2,11
1344,91,724,153,571,3,568,7,561,233,126,62,77,21,17,1,0,1,1,0,1,0,0,1,1,4,0,15
1345,91,739,196,543,3,540,2,538,204,112,105,62,16,13,0,2,0,0,0,2,0,0,1,2,2,0,17
1346,92,508,144,364,5,359,0,359,128,91,59,43,16,9,0,1,0,0,0,0,0,0,0,0,5,0,7
1347,92,557,160,397,4,393,2,391,127,106,81,51,13,5,0,1,0,0,0,0,0,0,1,0,3,0,3
1348,92,549,183,366,4,362,0,362,128,84,55,49,20,7,0,1,0,0,0,0,0,0,1,2,7,0,8
1349,92,980,335,645,7,638,8,630,240,131,120,70,32,17,0,1,0,1,0,0,0,0,1,0,7,0,10
1350,92,721,224,497,4,493,5,488,210,107,72,52,22,8,1,0,0,0,0,0,0,0,1,2,1,2,10
1351,92,756,251,505,2,503,8,495,204,102,79,67,25,6,0,0,0,0,0,0,0,0,0,1,5,0,6
1352,92,669,170,499,4,495,1,494,217,90,80,71,12,7,1,1,0,0,0,0,0,1,0,0,1,0,13
1353,92,641,160,481,2,479,1,478,205,115,58,56,18,8,0,2,0,0,2,1,0,0,1,0,2,0,10
1354,92,696,208,488,3,485,4,481,218,93,76,39,24,9,0,0,0,0,0,1,0,1,0,0,10,0,10
1355,92,896,247,649,3,646,14,632,304,122,70,80,15,21,0,1,0,0,0,0,0,1,0,1,0,1,16
1356,92,557,123,434,1,433,5,428,249,59,35,56,5,10,0,1,0,0,0,1,0,1,0,0,1,1,9
1357,92,550,110,440,3,437,2,435,285,57,24,36,7,8,0,0,0,0,0,1,0,1,0,2,1,0,13
1358,92,654,179,475,0,475,8,467,302,63,38,46,8,8,0,1,0,0,0,0,0,0,0,0,1,0,0
1359,92,592,149,443,1,442,4,438,275,66,28,43,5,2,0,0,0,0,0,0,0,0,0,0,3,0,16
1360,92,745,209,536,3,533,6,527,274,90,47,63,16,15,0,2,0,0,0,0,0,0,0,0,5,1,14
1361,92,858,196,662,2,660,5,655,359,113,52,81,14,6,0,0,0,0,1,0,0,0,0,1,3,2,23
1362,92,903,255,648,5,643,7,636,332,123,60,73,22,8,1,2,0,0,1,0,0,0,0,0,4,0,10
1363,92,676,229,447,2,445,2,443,205,100,61,43,18,5,1,0,0,0,0,0,0,1,0,0,2,0,7
1364,92,630,199,431,5,426,4,422,184,91,56,51,18,8,0,2,0,0,0,0,0,3,0,0,3,0,6
1365,92,564,149,415,2,413,1,412,229,62,39,38,12,5,1,0,0,0,1,2,0,0,0,0,2,1,20
1366,92,708,174,534,1,533,8,525,274,88,60,60,13,8,0,2,2,0,0,0,0,0,0,0,7,0,11
1367,92,906,280,626,7,619,6,613,257,136,88,76,27,7,0,0,0,0,0,0,1,1,0,1,4,0,15
1368,92,678,216,462,2,460,9,451,267,56,32,46,13,6,0,0,0,0,0,2,0,0,0,0,2,0,27
1369,92,645,179,466,4,462,4,458,256,63,48,54,10,7,0,1,0,0,0,0,0,0,1,1,2,2,13
1370,92,824,214,610,3,607,7,600,321,75,53,76,12,17,0,4,0,1,1,1,0,0,0,4,5,1,29
1371,92,982,224,758,6,752,6,746,450,126,44,77,9,10,0,1,0,0,0,0,0,1,3,0,2,0,23
1372,92,587,130,457,2,455,6,449,242,45,35,79,10,18,0,1,0,0,0,0,0,0,0,0,8,1,10
1373,93,531,177,354,7,347,4,343,124,97,43,47,15,7,0,0,0,0,0,0,2,0,1,0,1,0,6
1374,93,488,135,353,3,350,4,346,124,91,55,48,7,6,0,0,0,0,0,0,2,0,0,0,3,0,10
1375,93,603,142,461,2,459,7,452,283,52,25,56,6,5,0,0,0,0,0,0,0,0,0,0,1,0,24
1376,93,601,110,491,1,490,8,482,293,67,25,65,8,8,0,0,0,0,0,0,0,0,0,1,1,1,13
1377,93,708,151,557,4,553,8,545,309,85,38,58,15,8,0,0,0,0,0,2,1,0,0,1,1,0,27
1378,93,805,228,577,3,574,12,562,272,120,61,70,17,6,0,0,0,0,0,0,0,1,0,0,3,1,11
1379,93,806,196,610,7,603,9,594,250,121,63,113,21,11,0,0,0,0,1,0,0,0,0,1,4,0,9
1380,93,904,225,679,7,672,10,662,332,126,59,102,15,13,0,1,0,0,1,1,0,0,0,1,3,0,8
1381,93,520,123,397,4,393,3,390,154,100,55,45,20,6,0,0,0,1,0,0,0,0,1,0,1,0,7
1382,93,524,129,395,0,395,3,392,160,85,61,44,18,13,0,0,0,0,0,0,0,0,0,0,2,1,8
1383,93,901,214,687,8,679,5,674,251,200,110,64,28,10,0,0,0,0,0,0,0,0,1,2,1,0,7
1384,93,698,165,533,2,531,8,523,230,128,88,31,20,8,0,0,0,0,0,0,0,0,0,1,6,1,10
1385,93,598,142,456,2,454,9,445,250,77,57,39,8,4,0,0,0,0,0,0,0,0,0,1,4,0,5
1386,93,568,151,417,1,416,4,412,227,62,47,48,14,6,0,0,0,0,0,0,0,0,0,0,1,0,7
1387,93,608,126,482,5,477,5,472,330,55,16,44,5,5,0,0,0,0,0,1,0,0,0,1,1,0,14
1388,93,670,163,507,3,504,8,496,349,56,25,50,5,6,1,1,0,0,0,0,0,0,0,0,0,0,3
1389,93,914,235,679,1,678,8,670,340,103,80,88,17,17,0,0,0,1,0,0,0,0,0,1,2,2,19
1390,93,796,193,603,4,599,2,597,341,87,29,82,9,17,0,9,0,0,3,0,0,0,0,0,2,0,18
1391,94,583,147,436,1,435,2,433,153,110,50,67,25,13,0,0,0,0,0,0,0,0,0,0,5,0,10
1392,94,622,127,495,3,492,4,488,174,116,76,76,18,16,0,0,0,0,0,0,1,1,0,1,2,0,7
1393,94,525,146,379,0,379,2,377,124,106,79,29,20,8,0,0,0,0,1,0,1,0,0,0,5,0,4
1394,94,557,148,409,4,405,6,399,128,113,62,49,26,9,1,0,0,0,0,0,1,0,0,0,2,0,8
1395,94,876,218,658,5,653,1,652,217,162,139,65,35,12,0,0,1,0,1,1,0,0,2,1,13,0,3
1396,94,667,165,502,6,496,2,494,147,148,92,55,32,9,0,0,1,0,0,0,0,0,0,0,4,1,5
1397,94,589,151,438,3,435,5,430,121,129,94,41,23,13,0,0,0,0,0,0,0,0,0,2,4,0,3
1398,94,556,136,420,4,416,2,414,110,142,76,38,35,3,0,0,0,0,0,1,0,0,0,0,3,0,6
1399,94,808,207,601,4,597,6,591,164,185,118,71,26,11,0,0,0,0,0,1,0,0,0,1,6,1,7
1400,94,869,206,663,8,655,9,646,183,204,128,72,32,13,2,1,0,0,0,0,0,0,0,2,6,0,3
1401,94,663,138,525,1,524,5,519,147,154,79,98,14,9,0,2,0,0,1,0,0,1,1,0,5,0,8
1402,94,987,333,654,7,647,7,640,210,199,127,48,25,16,0,2,0,0,0,0,0,0,0,2,8,0,3
1403,94,706,175,531,1,530,6,524,169,163,82,68,18,9,0,0,0,0,0,3,0,0,0,0,2,0,10
1404,94,758,170,588,3,585,2,583,227,160,94,55,17,8,0,0,0,1,0,0,0,0,0,0,6,0,15
1405,94,909,207,702,6,696,9,687,259,178,105,91,29,5,1,0,0,0,0,1,0,2,0,0,7,0,9
1406,94,818,190,628,3,625,5,620,250,153,89,70,29,8,1,0,0,0,0,0,0,0,0,0,6,0,14
1407,94,691,199,492,1,491,2,489,146,160,106,43,21,8,0,0,0,0,0,0,0,0,0,2,2,0,1
1408,94,694,239,455,2,453,1,452,182,126,66,44,19,8,0,0,0,0,0,0,0,0,0,0,4,0,3
1409,94,560,176,384,3,381,2,379,106,142,73,27,19,6,0,0,0,0,0,1,0,1,0,1,3,0,0
1410,94,602,178,424,1,423,9,414,105,125,95,39,28,8,0,0,0,0,0,0,0,0,0,0,11,0,3
1411,94,722,251,471,3,468,2,466,124,169,86,31,31,12,0,0,0,0,1,1,1,0,4,0,5,0,1
1412,94,513,165,348,0,348,6,342,132,89,66,36,11,2,0,1,0,0,0,1,0,0,0,1,1,1,1
1413,94,545,172,373,2,371,5,366,118,99,71,37,24,10,0,0,0,0,1,0,0,0,1,0,2,1,2
1414,94,603,183,420,5,415,8,407,116,132,83,35,24,6,1,0,0,1,0,1,0,1,0,1,5,0,1
1415,94,562,176,386,4,382,5,377,112,138,64,37,14,5,0,0,0,0,0,2,0,0,0,1,3,0,1
1416,94,884,345,539,5,534,13,521,172,144,120,42,25,3,0,0,1,0,0,1,0,3,0,1,7,0,2
1417,94,619,230,389,3,386,2,384,147,129,60,24,9,6,1,1,0,0,2,0,0,0,1,1,2,0,1
1418,94,618,207,411,4,407,5,402,125,133,88,29,15,3,0,1,0,0,0,1,0,0,0,0,5,2,0
1419,94,798,282,516,2,514,7,507,156,160,106,42,22,8,0,1,1,1,0,0,0,1,1,0,2,0,6
1420,94,602,229,373,0,373,7,366,138,102,61,33,15,4,0,1,0,0,0,2,0,1,0,1,4,0,4
1421,94,652,203,449,0,449,8,441,264,69,47,40,7,4,1,0,0,1,0,0,0,0,0,1,6,0,1
1422,94,720,179,541,1,540,4,536,162,172,92,53,25,12,3,2,0,1,0,0,0,1,0,0,7,1,5
1423,94,680,155,525,4,521,3,518,162,167,73,64,28,9,0,0,0,0,0,0,0,0,0,0,8,0,7
1424,94,717,172,545,6,539,4,535,151,166,73,73,32,10,0,1,0,0,3,0,0,1,1,1,9,0,14
1425,95,804,181,623,4,619,5,614,457,48,7,77,4,4,0,1,0,0,0,0,0,0,0,1,0,0,15
1426,95,884,199,685,1,684,3,681,483,49,9,98,5,9,0,0,0,0,1,0,0,0,0,1,0,1,25
1427,95,529,114,415,2,413,4,409,279,36,9,54,0,4,0,1,0,0,0,0,0,1,0,0,3,0,22
1428,95,497,100,397,2,395,0,395,280,24,12,62,0,1,0,0,0,0,0,0,0,0,0,1,1,0,14
1429,95,536,154,382,5,377,2,375,251,24,5,75,1,3,0,0,0,0,0,1,0,0,0,0,2,0,13
1430,95,553,155,398,0,398,3,395,266,39,3,65,0,4,1,1,0,0,1,0,0,0,0,0,2,0,13
1431,96,925,251,674,1,673,6,667,436,72,38,87,5,6,0,3,0,0,0,0,0,1,0,0,0,1,18
1432,96,883,219,664,2,662,10,652,458,42,36,78,9,8,0,0,0,0,0,0,0,1,0,0,0,0,20
1433,97,584,105,479,1,478,4,474,276,53,14,85,3,8,0,4,0,0,0,0,0,0,0,0,3,0,28
1434,97,499,78,421,2,419,2,417,268,30,16,77,0,5,0,1,0,0,0,0,0,0,0,0,0,0,20
1435,97,590,161,429,0,429,6,423,201,87,54,40,15,8,0,1,0,1,0,1,0,0,0,1,2,0,12
1436,97,513,155,358,2,356,8,348,165,69,49,38,13,3,0,0,0,0,0,0,0,0,1,1,3,0,6
1437,97,798,213,585,1,584,8,576,349,90,37,61,9,7,0,1,0,0,1,0,0,0,0,0,1,0,20
1438,97,821,210,611,5,606,10,596,357,88,37,69,12,6,0,0,0,0,0,0,0,0,0,0,3,0,24
1439,97,683,252,431,4,427,3,424,162,118,81,40,7,5,0,0,0,0,1,1,0,0,3,1,3,0,2
1440,97,787,247,540,1,539,5,534,231,124,75,71,10,10,0,0,0,0,1,0,0,0,0,4,2,0,6
1441,97,710,165,545,3,542,4,538,423,26,4,59,4,1,0,1,0,0,0,0,0,0,0,1,5,0,14
1442,97,648,127,521,3,518,3,515,391,33,12,59,2,2,0,0,0,0,0,0,0,0,0,0,2,0,14
1443,97,874,145,729,3,726,6,720,128,225,208,61,77,8,0,0,0,0,1,0,0,0,0,0,3,1,8
1444,97,954,153,801,4,797,6,791,121,269,240,69,66,12,0,1,0,0,0,0,0,0,0,0,5,1,7
1445,97,938,168,770,4,766,11,755,334,137,87,119,27,20,0,1,0,0,0,1,0,0,1,0,3,2,23
1446,97,1002,199,803,3,800,9,791,344,179,85,119,23,13,0,2,0,0,1,1,0,0,0,0,7,0,17
1447,97,942,198,744,4,740,9,731,346,130,48,156,7,15,0,0,0,1,0,1,1,0,0,0,3,0,23
1448,97,836,187,649,1,648,14,634,320,98,52,132,6,7,0,0,0,0,0,1,0,0,0,1,2,0,15
1449,97,560,118,442,3,439,10,429,148,123,50,68,12,17,0,2,0,0,1,0,0,0,0,0,1,1,6
1450,97,577,135,442,1,441,4,437,162,105,48,65,19,16,0,2,0,0,0,0,0,0,0,0,2,1,17
1451,97,677,130,547,1,546,7,539,359,52,34,60,5,1,0,0,0,0,0,0,0,0,0,0,4,1,23
1452,97,741,135,606,0,606,9,597,382,67,33,70,14,6,1,0,0,0,2,0,0,0,0,0,5,0,17
1453,97,787,204,583,2,581,8,573,263,98,43,122,11,12,0,0,0,1,1,0,0,0,0,1,3,0,18
1454,97,862,221,641,6,635,9,626,271,104,75,124,14,11,0,0,0,1,1,0,4,0,1,0,3,0,17
1455,97,576,129,447,2,445,4,441,314,38,14,58,3,2,0,4,0,0,0,0,0,0,0,1,0,0,7
1456,97,528,73,455,1,454,3,451,277,47,21,77,3,11,1,0,0,0,0,1,0,0,0,0,3,1,9
1457,101,751,258,493,4,489,0,489,121,152,124,31,31,9,0,1,0,1,3,0,0,2,2,0,4,1,7
1458,101,699,388,311,1,310,0,310,70,85,81,27,26,12,1,0,0,0,0,0,0,0,1,0,6,0,1
1459,101,669,416,253,1,252,2,250,62,95,59,11,12,6,0,0,0,0,0,0,0,0,0,2,0,2,1
1460,101,562,219,343,4,339,2,337,90,108,72,28,22,6,0,0,0,0,0,0,0,1,1,1,4,3,1
1461,101,911,337,574,11,563,5,558,136,192,154,20,31,12,1,0,0,2,0,2,1,0,1,1,5,0,0
1462,101,818,259,559,2,557,5,552,138,164,115,71,22,17,1,0,0,0,1,2,0,2,1,0,8,1,9
1463,101,848,229,619,4,615,3,612,149,176,150,71,32,22,0,1,0,0,0,1,0,0,2,1,2,0,5
1464,101,810,291,519,5,514,3,511,132,164,111,48,32,7,1,0,1,2,0,1,1,0,2,1,4,1,3
1465,101,611,251,360,6,354,5,349,95,114,87,23,20,3,0,0,0,0,0,0,0,0,1,0,1,1,4
1466,101,774,286,488,4,484,8,476,127,178,90,37,25,11,0,1,1,0,0,0,0,0,0,3,1,0,2
1467,101,657,220,437,2,435,5,430,140,143,85,33,15,7,0,0,0,0,0,0,0,0,1,0,3,1,2
1468,101,573,179,394,7,387,5,382,157,97,70,31,15,4,1,0,0,0,0,0,0,0,0,0,5,0,2
1469,101,764,261,503,5,498,5,493,202,102,100,51,18,6,0,0,0,1,0,1,0,0,0,0,4,1,7
1470,101,520,110,410,5,405,6,399,114,122,64,54,23,11,0,0,0,0,0,0,0,2,1,2,2,0,4
1471,101,576,128,448,3,445,3,442,114,137,85,63,21,7,1,0,0,1,1,0,0,0,1,0,7,1,3
1472,101,736,234,502,5,497,3,494,190,118,89,51,22,8,0,2,1,0,0,0,0,0,1,0,6,0,6
1473,101,592,120,472,5,467,4,463,94,130,122,45,48,19,0,1,1,0,0,0,0,0,0,1,0,1,1
1474,101,590,99,491,5,486,7,479,73,152,141,35,50,11,0,1,0,0,0,0,0,1,1,1,7,2,4
1475,102,621,161,460,2,458,3,455,220,71,68,50,17,7,0,1,0,0,0,0,0,0,0,1,8,0,12
1476,102,733,124,609,3,606,2,604,134,182,170,57,36,7,0,0,0,0,0,0,0,0,0,1,7,0,10
1477,102,960,398,562,0,562,4,558,149,165,134,40,38,9,1,0,2,0,0,1,0,0,0,2,8,2,7
1478,102,954,291,663,7,656,6,650,247,155,125,73,22,9,0,2,0,1,0,0,0,1,0,1,3,0,11
1479,102,678,174,504,3,501,1,500,266,102,53,39,12,8,1,0,0,0,0,0,0,0,0,0,2,1,16
1480,102,557,224,333,3,330,3,327,111,81,81,17,19,7,0,0,1,0,0,0,0,0,0,0,5,0,5
1481,102,674,340,334,2,332,0,332,84,94,107,18,15,7,0,1,0,1,0,0,0,0,0,0,3,2,0
1482,102,970,320,650,2,648,7,641,195,170,175,52,25,13,0,0,0,0,0,1,0,0,0,2,6,0,2
1483,102,637,246,391,2,389,3,386,121,94,92,38,28,10,0,0,0,0,0,0,0,0,0,0,2,0,1
1484,102,629,238,391,4,387,2,385,133,88,102,32,19,5,0,0,0,1,2,0,0,0,0,0,2,0,1
1485,102,800,299,501,4,497,8,489,146,137,129,31,32,5,0,0,0,0,0,0,0,1,0,0,5,0,3
1486,102,858,323,535,4,531,8,523,175,133,121,51,24,3,0,0,1,0,0,1,3,1,1,2,2,0,5
1487,102,712,225,487,8,479,3,476,151,121,86,55,31,14,1,1,0,0,0,0,0,0,0,0,8,0,8
1488,102,890,290,600,8,592,5,587,188,154,136,44,37,10,0,0,0,1,0,0,0,1,0,0,5,3,8
1489,102,808,319,489,5,484,8,476,166,129,108,30,26,9,1,0,0,0,1,0,0,0,0,0,3,0,3
1490,102,987,373,614,12,602,10,592,226,150,113,50,23,13,0,1,0,0,0,3,0,3,1,1,2,3,3
1491,102,910,390,520,1,519,2,517,123,167,129,42,36,6,2,0,0,0,0,0,0,1,0,1,6,1,3
1492,102,565,193,372,3,369,1,368,104,101,86,37,24,7,0,0,0,0,0,2,0,1,1,0,3,0,2
1493,102,950,396,554,14,540,4,536,144,147,139,53,39,5,0,0,0,0,0,0,0,2,2,0,3,0,2
1494,102,665,213,452,3,449,4,445,125,146,108,32,14,9,0,0,0,0,0,0,0,0,4,0,2,1,4
1495,102,517,222,295,2,293,3,290,78,89,75,20,12,4,0,0,0,0,0,0,1,1,0,4,3,0,3
1496,102,735,270,465,5,460,3,457,161,118,105,29,30,6,0,0,1,2,0,0,0,0,0,1,1,0,3
1497,102,516,178,338,4,334,3,331,124,76,64,26,26,4,0,0,1,0,0,1,0,2,0,1,2,0,4
1498,102,592,183,409,5,404,6,398,148,95,75,38,28,4,0,0,0,0,0,1,1,0,0,0,4,0,4
1499,102,557,224,333,1,332,7,325,85,86,88,30,12,10,0,0,0,0,1,0,0,0,1,2,6,1,3
1500,102,575,217,358,6,352,7,345,97,118,69,28,19,4,0,0,0,0,1,0,0,0,2,0,5,2,0
1501,102,568,194,374,2,372,4,368,109,92,91,41,18,4,0,0,0,0,0,0,1,0,0,1,4,3,4
1502,102,863,340,523,5,518,4,514,173,145,100,43,22,14,0,1,0,0,0,0,0,0,0,2,8,2,4
1503,102,697,327,370,3,367,2,365,83,117,77,36,31,11,1,0,1,1,0,0,0,0,0,0,4,0,3
1504,102,536,180,356,5,351,3,348,95,113,76,31,17,6,0,1,0,0,0,0,0,2,0,0,5,1,1
1505,102,508,191,317,4,313,1,312,86,106,65,33,15,5,1,0,0,0,0,0,0,0,0,0,1,0,0
1506,102,979,366,613,4,609,7,602,172,182,124,70,22,13,0,0,0,1,0,0,0,0,0,1,10,1,6
1507,102,550,185,365,6,359,2,357,132,94,83,29,10,2,0,0,0,1,0,1,0,0,0,0,1,1,3
1508,102,519,193,326,4,322,3,319,118,85,60,29,14,3,0,1,0,0,0,1,0,1,1,0,4,1,1
1509,102,657,180,477,8,469,6,463,188,114,82,42,17,10,0,0,1,0,0,0,0,3,0,0,1,0,5
1510,102,990,385,605,2,603,0,603,158,190,146,50,35,17,0,0,0,0,0,1,0,1,1,0,2,0,2
1511,102,597,274,323,6,317,2,315,103,79,67,30,15,10,0,0,0,0,0,0,0,0,0,0,4,2,5
1512,102,793,300,493,0,493,1,492,163,129,115,47,16,9,4,0,0,0,0,0,1,0,0,0,5,0,3
1513,102,801,294,507,4,503,1,502,151,148,101,51,11,14,2,0,0,0,1,0,0,1,1,2,11,2,6
1514,102,508,164,344,3,341,3,338,135,81,50,39,14,5,0,0,0,0,0,1,1,0,0,0,4,0,8
1515,102,525,149,376,3,373,4,369,122,106,75,32,16,5,0,0,0,0,0,0,0,0,0,0,7,1,5
1516,102,877,211,666,4,662,9,653,245,186,118,48,22,17,1,1,0,0,0,0,0,0,0,1,6,2,6
1517,103,969,411,558,4,554,4,550,172,170,124,45,24,10,0,0,1,1,0,0,0,0,1,0,1,0,1
1518,103,709,246,463,5,458,2,456,171,104,99,47,11,12,0,0,0,0,0,0,1,0,0,1,4,3,3
1519,103,800,275,525,11,514,7,507,200,126,104,40,21,2,0,0,0,0,0,0,0,2,1,0,8,1,2
1520,103,782,276,506,10,496,2,494,143,150,102,43,23,7,1,0,0,1,0,1,0,2,0,1,5,3,12
1521,103,525,131,394,3,391,5,386,162,100,57,37,20,3,0,0,0,0,0,0,0,0,0,2,3,0,2
1522,103,553,132,421,4,417,4,413,164,104,65,45,14,7,0,0,0,0,0,0,1,0,0,1,3,1,8
1523,103,946,277,669,7,662,3,659,257,148,115,65,29,11,0,2,3,1,0,1,0,0,0,2,7,0,18
1524,103,717,264,453,5,448,7,441,106,153,103,35,30,7,0,0,0,0,0,0,0,2,0,0,3,0,2
1525,103,549,228,321,2,319,3,316,77,112,68,24,10,9,0,0,0,1,0,0,0,1,0,1,11,0,2
1526,103,503,215,288,1,287,0,287,74,100,61,24,14,6,1,0,0,0,0,0,0,1,0,1,2,0,3
1527,103,777,295,482,7,475,8,467,127,133,107,46,14,18,1,0,0,1,0,1,0,0,0,0,14,1,4
1528,103,838,338,500,6,494,6,488,103,156,135,36,28,17,0,1,0,1,0,0,0,3,1,0,4,1,2
1529,103,619,199,420,2,418,3,415,99,157,91,39,17,5,0,1,0,0,0,0,0,1,0,0,2,1,2
1530,103,514,170,344,2,342,3,339,63,118,83,33,21,11,0,1,1,0,1,0,0,0,0,0,3,0,4
1531,103,382,84,298,1,297,4,293,139,55,39,35,7,14,0,0,0,0,0,0,0,0,0,0,0,2,2
1532,103,520,202,318,5,313,1,312,99,100,55,27,22,4,0,0,0,0,0,0,0,0,1,0,4,0,0
1533,103,577,243,334,1,333,1,332,101,101,91,21,9,2,0,0,0,0,0,0,0,1,0,0,4,0,2
1534,103,660,300,360,2,358,7,351,83,131,94,20,11,4,0,0,0,0,1,2,1,0,0,0,3,0,1
1535,103,577,234,343,3,340,2,338,78,114,86,27,20,6,0,0,0,0,0,1,0,0,0,2,3,0,1
1536,103,597,242,355,0,355,0,355,97,124,71,30,13,11,0,0,0,1,0,1,1,1,0,3,2,0,0
1537,103,620,249,371,1,370,0,370,120,111,83,24,17,7,0,0,1,0,0,0,0,0,1,0,5,0,1
1538,103,726,223,503,2,501,2,499,177,127,98,46,24,12,0,0,0,0,2,0,0,0,0,2,6,1,4
1539,103,648,197,451,2,449,4,445,163,123,81,38,18,12,0,0,0,0,0,1,0,0,0,1,4,1,3
1540,103,496,172,324,4,320,3,317,112,73,68,28,15,6,0,0,0,1,0,0,0,0,0,0,6,1,7
1541,103,532,206,326,4,322,6,316,111,83,55,38,14,2,0,0,0,1,0,0,1,0,0,0,4,0,7
1542,103,830,297,533,8,525,3,522,220,115,111,34,20,8,0,1,0,0,0,0,0,0,2,0,0,2,9
1543,103,830,251,579,2,577,11,566,254,129,99,42,19,7,1,1,0,0,0,0,0,2,0,0,5,1,6
1544,103,844,225,619,4,615,9,606,261,128,112,49,29,8,3,1,0,0,0,0,0,1,1,3,3,1,6
1545,103,785,259,526,3,523,10,513,182,139,99,50,23,7,0,2,0,0,0,0,0,0,0,1,2,1,7
1546,103,637,154,483,1,482,5,477,191,125,68,45,12,20,0,0,0,1,0,0,0,2,0,0,7,0,6
1547,103,636,187,449,6,443,8,435,143,120,91,47,12,9,0,0,0,1,1,0,1,1,0,1,1,0,7
1548,103,746,215,531,3,528,1,527,201,133,119,29,28,5,0,0,0,0,1,0,0,1,0,1,7,0,2
1549,103,586,218,368,5,363,1,362,98,132,72,27,20,7,0,0,0,0,0,0,0,1,0,0,3,0,2
1550,103,849,271,578,4,574,8,566,166,172,133,49,29,8,1,0,0,0,0,0,0,0,0,0,2,0,6
1551,103,881,203,678,8,670,8,662,273,170,100,63,31,11,0,0,0,0,0,0,0,0,0,2,2,10,0
1552,103,842,155,687,3,684,10,674,175,184,146,75,50,30,0,0,0,0,1,0,0,1,0,1,7,1,3
1553,103,905,195,710,4,706,7,699,190,191,162,70,41,29,0,1,0,0,0,0,1,0,1,0,5,2,6
1554,103,842,189,653,5,648,5,643,188,146,138,105,32,19,0,0,0,0,0,2,1,2,1,1,5,1,2
1555,104,540,119,421,4,417,6,411,170,93,57,53,17,11,0,0,0,0,0,0,0,0,0,0,6,1,3
1556,104,657,249,408,1,407,10,397,116,124,92,25,22,4,0,0,0,0,0,0,0,1,1,0,9,0,3
1557,104,554,184,370,6,364,0,364,85,121,84,31,21,4,2,0,0,0,0,0,0,1,0,3,8,1,3
1558,104,660,273,387,3,384,3,381,111,115,86,32,14,11,0,1,0,0,1,0,0,0,0,0,6,0,4
1559,104,642,277,365,1,364,1,363,100,136,55,29,26,8,1,0,0,0,0,0,0,0,0,0,6,0,2
1560,104,548,217,331,2,329,6,323,98,113,78,17,9,2,2,0,0,0,0,0,0,0,1,1,2,0,0
1561,104,515,191,324,2,322,1,321,81,127,59,24,16,5,0,0,0,1,0,0,0,0,1,0,2,1,4
1562,104,944,252,692,2,690,5,685,290,159,87,95,21,11,0,0,0,0,0,1,0,0,1,2,4,1,13
1563,104,940,298,642,3,639,3,636,255,194,116,31,16,12,6,0,0,0,0,0,0,0,0,0,0,1,5
1564,104,820,252,568,2,566,2,564,203,158,90,49,41,10,0,0,0,2,0,0,1,2,0,0,0,0,8
1565,104,764,240,524,2,522,3,519,204,150,96,36,14,10,1,0,0,0,0,0,3,1,0,0,2,0,2
1566,104,887,185,702,7,695,6,689,260,184,135,55,31,16,0,0,0,0,0,1,0,2,0,0,2,0,3
1567,104,649,187,462,5,457,7,450,138,114,102,57,22,10,0,0,1,0,0,0,0,0,0,0,5,0,1
1568,104,664,203,461,7,454,2,452,125,127,98,41,29,10,2,0,1,2,0,1,0,3,0,0,4,1,8
1569,104,743,277,466,3,463,1,462,141,156,94,30,22,7,0,0,0,1,1,1,1,0,2,0,2,1,3
1570,104,855,275,580,5,575,9,566,197,178,100,54,17,9,0,0,0,0,0,0,0,0,0,0,6,1,4
1571,104,995,353,642,12,630,4,626,197,171,157,46,32,10,2,0,0,1,0,0,2,0,0,0,6,0,2
1572,104,841,245,596,5,591,10,581,156,216,113,47,16,13,1,0,0,1,0,1,0,3,0,1,7,0,6
1573,104,907,234,673,9,664,3,661,236,201,117,67,17,11,2,1,0,0,0,0,0,0,1,0,2,2,4
1574,104,775,252,523,3,520,6,514,180,149,89,46,23,9,1,1,0,0,0,0,0,0,2,0,7,1,6
1575,104,859,243,616,3,613,17,596,244,162,96,54,24,7,0,2,0,1,0,0,0,0,1,0,2,1,2
1576,104,562,153,409,2,407,4,403,157,118,62,37,17,2,0,0,0,1,0,0,0,0,0,0,1,2,6
1577,104,861,302,559,9,550,4,546,154,197,101,49,21,10,0,0,0,0,0,1,1,0,0,1,5,3,3
1578,104,507,137,370,3,367,7,360,118,114,55,27,20,13,1,0,2,1,1,1,0,0,0,0,4,3,0
1579,104,639,142,497,2,495,1,494,216,108,82,50,13,13,0,0,0,1,0,0,0,0,0,1,4,0,6
1580,104,597,143,454,2,452,6,446,190,109,61,45,16,10,1,0,0,1,2,0,0,0,1,0,1,0,9
1581,104,910,168,742,7,735,5,730,297,202,98,67,36,9,0,0,1,0,0,2,0,0,0,0,4,2,12
1582,104,651,144,507,7,500,5,495,204,144,61,41,19,8,0,0,0,0,0,0,0,3,0,0,4,2,9
1583,104,589,164,425,3,422,4,418,180,98,70,40,17,5,0,1,0,0,0,0,0,0,0,0,4,0,3
1584,104,591,154,437,3,434,6,428,194,113,44,45,16,6,0,2,0,0,1,0,0,0,0,0,4,2,1
1585,104,609,217,392,5,387,1,386,114,131,79,29,15,7,0,0,0,0,1,1,0,1,0,1,2,1,4
1586,104,526,210,316,5,311,3,308,73,113,78,18,14,4,0,0,0,1,0,0,0,1,0,2,3,1,0
1587,104,654,236,418,8,410,1,409,136,119,88,36,21,3,0,0,1,1,0,0,0,0,0,0,2,0,2
1588,104,665,248,417,5,412,2,410,116,137,91,28,20,6,1,0,0,1,2,3,0,1,1,0,1,0,2
1589,104,733,269,464,4,460,2,458,107,167,106,34,25,6,1,0,1,1,0,1,0,2,0,0,5,2,0
1590,104,773,235,538,5,533,9,524,174,167,105,38,25,6,1,0,0,0,0,0,0,4,0,1,2,0,1
1591,104,578,155,423,3,420,6,414,166,117,52,48,14,4,0,1,1,0,0,0,0,0,1,0,3,1,6
1592,104,552,147,405,0,405,9,396,167,107,50,37,13,5,2,0,0,1,0,0,0,0,0,0,4,2,8
1593,104,495,136,359,3,356,6,350,121,83,63,46,10,13,0,0,0,0,2,0,0,2,0,0,6,1,3
1594,104,558,115,443,6,437,4,433,162,123,62,54,15,10,0,0,0,0,0,0,0,0,1,0,4,0,2
1595,104,936,249,687,5,682,6,676,263,181,122,52,30,12,0,0,1,0,0,0,0,1,0,1,8,1,4
1596,104,662,141,521,6,515,2,513,197,150,67,55,22,9,0,0,0,0,0,0,0,0,0,1,3,0,9
1597,104,742,131,611,6,605,3,602,232,140,106,68,23,15,1,0,0,0,0,0,0,0,0,0,5,0,12
1598,104,932,244,688,1,687,3,684,232,175,128,66,38,9,2,0,1,0,0,0,0,1,1,1,20,3,7
1599,104,930,232,698,6,692,10,682,228,198,165,26,42,6,0,2,0,1,0,2,0,2,1,0,4,0,5
1600,104,891,202,689,3,686,10,676,282,198,80,71,22,12,0,0,0,2,0,0,0,2,0,1,0,0,6
1601,104,769,224,545,5,540,5,535,218,149,64,49,20,19,0,0,0,0,1,2,0,1,0,0,3,3,6
1602,104,976,297,679,3,676,7,669,251,180,131,51,22,13,1,0,1,1,0,0,0,0,1,2,7,0,8
1603,104,611,160,451,10,441,2,439,142,124,95,46,18,4,0,1,0,0,0,0,0,0,1,0,5,1,2
1604,104,927,323,604,5,599,16,583,171,163,126,65,26,12,0,0,0,1,0,2,0,2,0,0,8,2,5
1605,104,768,232,536,8,528,5,523,181,169,87,41,23,9,0,0,0,0,1,0,0,3,0,0,5,2,2
1606,104,1000,285,715,6,709,3,706,240,181,135,78,38,9,0,0,0,0,1,0,2,0,1,2,8,1,10
1607,104,566,141,425,5,420,3,417,232,79,51,32,10,4,1,0,0,0,0,0,0,0,0,0,2,0,6
1608,104,622,172,450,5,445,3,442,195,118,58,28,20,10,0,0,0,1,0,1,0,1,0,0,3,0,7
1609,104,650,154,496,5,491,2,489,214,117,67,36,18,12,0,0,0,0,0,0,0,3,1,0,10,0,11
1610,104,874,261,613,7,606,5,601,260,144,89,56,26,14,1,1,0,0,0,0,2,1,0,0,3,0,4
1611,104,590,166,424,2,422,5,417,192,85,65,42,14,7,1,1,0,0,0,0,0,0,3,1,0,1,5
1612,104,625,154,471,6,465,5,460,167,128,61,57,19,9,0,0,1,0,0,0,1,1,1,1,7,0,7
1613,104,697,188,509,4,505,6,499,171,139,86,52,22,9,0,0,0,0,0,1,1,0,1,0,6,0,11
1614,104,540,148,392,1,391,2,389,212,69,51,30,8,9,0,0,0,1,0,0,0,1,0,1,5,0,2
1615,104,637,184,453,6,447,9,438,164,106,82,36,21,10,0,0,0,0,0,0,2,2,1,2,3,1,8
1616,104,884,239,645,4,641,7,634,198,194,122,48,46,15,0,0,0,0,1,0,0,0,1,0,0,5,4
1617,104,670,219,451,8,443,3,440,143,128,87,32,30,6,0,0,0,0,0,0,0,1,1,1,9,0,2
1618,104,623,122,501,7,494,6,488,188,115,80,52,29,8,1,0,0,0,0,0,0,0,0,0,6,0,9
1619,104,785,268,517,4,513,6,507,153,144,128,35,22,4,0,0,0,1,0,0,4,0,1,2,7,2,4
1620,104,670,161,509,5,504,1,503,202,132,79,46,22,13,0,0,0,0,0,0,0,0,1,0,2,0,6
1621,104,644,217,427,7,420,4,416,143,108,89,41,16,3,1,0,0,0,1,1,0,1,0,3,2,0,7
1622,104,596,195,401,3,398,4,394,145,91,81,38,19,4,0,0,1,0,1,0,0,1,0,1,9,0,3
1623,104,949,299,650,3,647,4,643,247,181,95,64,20,17,1,0,0,0,0,2,1,1,0,0,6,0,8
1624,104,617,134,483,6,477,5,472,204,107,78,41,19,14,0,0,0,0,0,0,0,0,0,1,2,0,6
1625,104,554,144,410,8,402,3,399,184,86,57,39,15,8,3,0,0,0,0,0,0,1,0,0,3,0,3
1626,105,832,339,493,1,492,6,486,170,130,92,37,26,13,0,1,0,1,0,0,0,1,1,0,9,0,5
1627,105,518,155,363,3,360,4,356,144,79,68,32,16,7,0,0,0,1,0,0,0,1,0,0,1,2,5
1628,105,558,202,356,4,352,3,349,129,92,62,24,21,7,0,1,0,0,0,0,0,0,1,0,3,0,9
1629,105,911,301,610,6,604,8,596,223,153,114,49,31,10,0,1,0,0,0,0,0,1,0,0,4,0,10
1630,105,990,395,595,11,584,12,572,189,151,120,62,20,7,0,1,2,1,0,3,0,2,0,1,8,0,5
1631,105,940,411,529,1,528,0,528,141,160,148,38,27,8,0,0,0,1,0,0,0,1,0,0,1,0,3
1632,105,627,206,421,7,414,4,410,144,120,68,42,19,6,0,0,0,1,0,3,0,0,1,0,2,0,4
1633,105,577,195,382,9,373,2,371,122,106,76,35,17,8,0,0,1,0,0,1,0,0,0,1,3,0,1
1634,105,683,241,442,3,439,2,437,167,110,67,38,26,11,0,0,0,1,0,1,0,2,1,1,5,1,6
1635,105,611,236,375,9,366,4,362,127,112,50,38,15,9,0,0,0,0,0,1,0,0,0,0,2,1,7
1636,105,630,153,477,7,470,2,468,240,61,70,59,12,13,1,1,0,1,0,0,0,1,0,0,5,0,4
1637,105,869,201,668,10,658,8,650,232,151,106,107,32,13,0,1,0,0,1,0,0,0,1,0,3,0,3
1638,105,910,240,670,3,667,8,659,234,149,128,85,31,19,0,1,0,0,3,0,0,1,0,0,3,0,5
1639,105,637,173,464,6,458,0,458,161,129,73,34,33,17,0,3,2,0,0,0,0,0,0,1,2,0,3
1640,105,826,188,638,4,634,8,626,456,27,28,65,3,7,0,2,1,0,0,0,0,0,0,4,1,0,32
1641,105,687,136,551,5,546,7,539,380,23,31,52,5,8,0,1,0,0,0,3,0,0,0,1,5,0,30
1642,105,518,128,390,7,383,2,381,206,35,26,66,11,14,0,0,0,0,0,1,0,1,0,0,6,2,13
1643,105,593,178,415,10,405,4,401,208,38,36,79,7,13,0,0,0,0,0,1,0,0,0,3,4,2,10
1644,105,552,134,418,7,411,6,405,219,29,35,89,2,15,0,0,0,2,1,0,0,0,1,0,4,1,7
1645,105,567,144,423,3,420,2,418,239,27,19,81,3,17,0,1,0,0,1,1,0,0,0,1,8,0,20
1646,106,550,170,380,5,375,4,371,110,110,55,65,17,7,0,0,0,0,0,0,0,0,0,0,4,1,2
1647,106,728,248,480,7,473,5,468,126,127,76,92,22,11,1,1,0,0,0,0,1,1,1,1,4,1,3
1648,106,678,227,451,1,450,4,446,116,140,71,82,8,14,0,0,0,0,0,0,0,0,0,2,6,1,6
1649,106,673,217,456,9,447,3,444,93,125,109,72,23,11,0,0,2,0,0,0,0,0,0,1,4,0,4
1650,106,756,218,538,6,532,5,527,95,135,142,75,36,24,0,0,0,1,2,0,0,0,0,0,10,1,6
1651,107,591,176,415,8,407,4,403,147,100,62,48,21,13,1,0,0,0,0,0,0,1,0,3,5,1,1
1652,107,656,180,476,2,474,6,468,150,128,100,50,15,13,0,1,0,0,0,0,0,0,0,1,7,0,3
1653,107,708,234,474,9,465,4,461,157,135,72,45,22,10,1,0,2,0,0,0,1,1,0,1,4,3,7
1654,107,600,136,464,3,461,6,455,207,117,72,27,9,9,0,0,0,2,0,0,0,0,0,0,3,2,7
1655,107,985,345,640,5,635,3,632,198,181,137,49,32,12,0,1,0,0,0,2,0,4,0,2,11,1,2
1656,107,932,255,677,6,671,6,665,239,137,153,78,16,18,0,5,0,0,1,4,0,0,0,4,5,1,4
1657,107,865,227,638,7,631,6,625,171,180,135,72,37,16,0,1,0,1,0,2,0,0,1,0,4,0,5
1658,107,841,221,620,5,615,10,605,137,166,151,80,40,15,0,0,0,2,0,0,0,0,0,1,3,2,8
1659,107,939,297,642,10,632,4,628,213,179,126,55,21,11,5,0,0,0,0,0,0,2,3,1,6,0,6
1660,107,596,179,417,1,416,4,412,107,133,95,37,24,6,0,0,1,0,0,0,0,0,0,1,6,0,2
1661,107,921,242,679,11,668,7,661,176,216,143,67,22,12,3,1,0,0,3,1,0,0,0,2,6,2,7
1662,107,899,239,660,8,652,8,644,218,183,141,67,20,7,0,0,1,0,0,0,0,0,1,0,5,0,1
1663,107,580,151,429,2,427,7,420,151,115,63,51,15,5,2,0,0,0,1,0,0,0,0,1,9,1,6
1664,107,602,151,451,6,445,3,442,135,114,91,57,30,3,0,0,0,0,1,0,0,1,2,1,3,0,4
1665,107,651,152,499,5,494,4,490,143,153,94,55,23,10,0,0,0,0,0,0,0,1,1,0,6,1,3
1666,107,763,186,577,3,574,8,566,178,173,112,63,19,12,0,0,0,0,0,0,0,2,0,1,4,0,2
1667,107,667,192,475,6,469,2,467,162,112,93,49,23,13,0,0,0,0,0,0,0,2,0,0,9,2,2
1668,107,489,128,361,4,357,5,352,119,98,74,29,17,7,0,0,0,0,0,1,0,1,0,1,2,1,2
1669,107,522,153,369,6,363,3,360,104,116,70,23,28,8,0,0,1,0,1,0,0,0,0,0,5,0,4
1670,107,877,229,648,7,641,7,634,209,187,133,45,21,14,1,1,0,0,0,0,0,1,2,1,10,1,8
1671,107,921,290,631,7,624,3,621,217,193,125,34,33,7,0,0,1,0,0,0,0,1,0,2,3,0,5
1672,107,976,252,724,2,722,13,709,236,199,133,84,26,9,1,2,0,0,1,0,0,1,0,0,8,3,6
1673,107,964,304,660,3,657,2,655,201,194,140,60,31,9,0,2,3,1,0,0,0,2,0,0,8,1,3
1674,107,796,288,508,3,505,9,496,146,157,98,54,20,8,0,0,0,0,0,3,0,0,0,0,7,2,1
1675,107,826,255,571,2,569,4,565,185,166,115,50,19,10,3,1,0,0,1,0,0,0,0,1,7,5,2
1676,107,817,210,607,2,605,10,595,188,192,114,49,16,14,1,2,1,0,0,1,0,4,3,2,3,0,5
1677,107,566,174,392,0,392,0,392,88,136,86,40,28,0,1,0,0,0,0,2,0,0,0,0,3,0,8
1678,107,986,326,660,10,650,2,648,163,188,154,71,31,20,2,0,0,0,0,0,0,0,3,2,9,1,4
1679,107,779,257,522,3,519,6,513,149,171,104,47,21,7,0,0,0,1,0,1,0,2,1,0,4,1,4
1680,107,578,199,379,0,379,0,379,124,117,67,39,20,3,1,2,0,0,0,0,0,0,0,2,1,1,2
1681,107,630,209,421,4,417,2,415,118,144,81,29,25,7,1,0,0,0,1,0,0,1,0,2,2,2,2
1682,107,855,236,619,8,611,6,605,208,152,128,46,32,19,1,0,0,0,0,0,0,0,0,1,8,5,5
1683,107,625,195,430,9,421,1,420,113,145,86,36,19,6,1,1,0,1,0,1,0,0,1,1,7,0,2
1684,107,634,188,446,6,440,3,437,124,158,78,34,27,3,0,0,0,1,0,0,0,3,0,2,6,0,1
1685,107,746,200,546,4,542,6,536,176,161,115,39,23,10,0,2,0,0,0,1,0,1,0,0,5,0,3
1686,107,673,194,479,2,477,7,470,163,129,81,37,27,19,1,0,0,0,0,2,0,0,1,0,7,0,3
1687,107,689,208,481,3,478,4,474,99,213,95,36,21,2,1,0,0,0,0,0,0,0,0,1,3,0,3
1688,107,762,201,561,5,556,0,556,178,161,118,49,30,7,0,1,1,0,1,1,0,1,0,0,4,0,4
1689,107,511,193,318,7,311,4,307,102,63,57,54,16,9,0,0,0,0,0,1,0,0,0,0,3,0,2
1690,107,933,319,614,11,603,5,598,250,138,100,62,20,12,0,0,2,2,1,0,0,1,0,0,5,0,5
1691,107,576,179,397,4,393,2,391,141,105,78,29,15,5,1,0,0,1,0,1,0,1,0,2,9,0,3
1692,107,525,143,382,4,378,2,376,110,110,86,34,14,7,0,0,0,0,0,1,0,1,0,0,6,1,6
1693,107,651,190,461,6,455,1,454,167,141,66,45,14,6,0,0,0,0,0,0,0,1,1,1,2,0,10
1694,107,692,190,502,11,491,4,487,194,145,68,38,14,16,0,1,0,0,0,1,0,0,2,1,3,0,4
1695,107,885,235,650,9,641,3,638,217,181,112,69,25,10,1,0,0,2,0,0,4,0,1,0,7,2,7
1696,107,600,154,446,4,442,1,441,151,123,88,34,20,9,1,0,0,0,0,0,0,0,0,3,6,0,6
1697,107,652,183,469,8,461,3,458,155,137,77,47,23,11,1,0,0,0,0,0,0,0,0,1,2,2,2
1698,107,632,206,426,4,422,4,418,132,134,82,28,15,18,1,0,0,0,0,0,0,0,0,0,2,1,5
1699,107,683,216,467,2,465,3,462,152,131,107,34,22,6,1,0,0,0,1,0,0,0,0,0,2,1,5
1700,107,614,130,484,3,481,4,477,164,128,94,53,14,8,0,1,0,1,0,2,0,0,0,1,3,1,7
1701,107,666,175,491,6,485,1,484,144,139,96,56,17,10,0,0,0,0,0,0,0,3,1,1,3,1,13
1702,107,503,130,373,4,369,10,359,100,133,67,25,15,11,1,1,0,0,0,0,0,0,0,1,3,0,2
1703,107,527,129,398,1,397,3,394,124,111,80,33,19,10,0,1,0,0,0,1,0,1,0,2,5,1,6
1704,107,967,321,646,3,643,8,635,176,187,149,64,27,12,2,0,0,0,0,1,0,2,0,2,8,1,4
1705,107,716,140,576,8,568,4,564,120,145,166,65,34,10,1,0,2,1,0,0,1,1,1,2,8,2,5
1706,107,761,172,589,6,583,7,576,124,173,146,68,36,11,4,0,0,0,0,0,0,3,2,0,3,0,6
1707,111,862,314,548,2,546,6,540,187,146,109,59,24,2,0,0,0,1,1,0,0,0,0,0,4,0,7
1708,111,683,215,468,5,463,2,461,176,112,100,29,21,7,0,0,0,1,0,0,1,0,1,1,5,0,7
1709,111,599,166,433,6,427,2,425,159,109,83,36,17,7,0,1,0,0,0,0,0,1,0,1,4,1,6
1710,111,733,226,507,6,501,3,498,209,128,67,53,23,8,0,0,0,0,0,2,0,0,0,0,3,0,5
1711,111,718,226,492,4,488,9,479,215,116,74,38,15,5,1,1,0,0,0,0,0,0,0,2,4,1,7
1712,111,599,164,435,2,433,8,425,164,113,55,40,28,11,0,0,0,0,1,0,0,0,2,0,3,0,8
1713,111,628,172,456,3,453,1,452,169,115,90,41,13,10,0,1,0,0,0,0,0,2,1,0,5,0,5
1714,111,939,300,639,4,635,11,624,262,166,84,57,33,7,0,0,1,0,0,0,0,0,1,2,4,0,7
1715,111,982,315,667,8,659,1,658,254,163,105,73,42,6,0,0,0,0,1,2,0,0,1,3,4,0,4
1716,111,694,273,421,7,414,1,413,135,120,86,32,22,7,1,0,0,3,0,0,0,0,0,1,3,1,2
1717,111,700,286,414,1,413,2,411,110,127,99,34,25,7,1,0,1,0,0,0,0,0,2,0,1,3,1
1718,111,680,226,454,4,450,4,446,163,104,79,47,23,13,0,0,0,0,1,0,0,1,1,1,4,1,8
1719,111,628,197,431,2,429,3,426,141,139,76,27,27,8,0,0,0,0,0,0,0,0,2,0,1,0,5
1720,111,705,279,426,0,426,0,426,134,122,82,35,30,13,0,0,0,0,1,0,0,1,0,1,2,1,4
1721,111,730,302,428,1,427,0,427,124,135,84,43,29,3,0,0,0,1,0,1,0,0,0,0,3,3,1
1722,111,533,191,342,4,338,2,336,98,101,71,31,17,5,0,1,0,0,0,0,0,0,1,3,3,2,3
1723,111,536,217,319,2,317,1,316,99,73,82,29,15,5,0,0,0,0,0,1,2,0,0,3,4,1,2
1724,111,529,196,333,8,325,4,321,94,105,57,32,19,7,2,0,0,0,0,0,0,0,0,0,2,0,3
1725,111,574,219,355,5,350,6,344,114,103,73,21,12,3,1,1,0,0,0,0,0,0,0,1,4,3,8
1726,111,816,309,507,4,503,7,496,158,138,115,39,19,9,1,1,1,0,0,1,0,1,2,1,6,1,3
1727,111,881,379,502,8,494,2,492,93,179,124,44,30,7,1,0,1,0,2,1,0,0,0,1,7,0,2
1728,111,606,248,358,0,358,2,356,86,122,72,41,13,6,1,0,1,0,0,0,0,2,1,0,5,2,4
1729,111,517,177,340,2,338,3,335,142,92,50,25,7,7,0,0,0,0,0,0,0,0,0,2,5,0,5
1730,111,918,398,520,3,517,2,515,154,146,121,30,34,14,0,1,0,0,0,1,1,0,3,1,5,1,3
1731,112,576,201,375,2,373,4,369,94,105,85,47,16,10,0,0,0,0,0,1,0,1,0,1,3,1,5
1732,112,516,143,373,4,369,4,365,122,95,65,43,24,7,0,0,0,0,1,0,0,1,0,0,4,0,3
1733,112,884,317,567,6,561,8,553,159,181,123,36,20,13,1,1,1,0,0,0,1,0,0,0,6,1,10
1734,112,987,404,583,6,577,2,575,176,180,140,47,21,3,0,0,0,0,0,0,0,1,0,0,3,1,3
1735,112,977,330,647,6,641,3,638,202,170,149,66,28,7,0,1,0,2,0,2,1,0,0,1,4,3,2
1736,112,792,253,539,10,529,6,523,187,161,86,40,20,11,1,1,0,0,1,1,1,1,2,0,5,0,5
1737,112,725,231,494,5,489,6,483,163,136,87,41,30,9,1,0,2,1,0,0,0,0,3,0,1,0,9
1738,112,779,200,579,1,578,7,571,238,148,97,42,20,5,1,0,0,0,0,1,0,0,0,0,6,0,13
1739,112,687,260,427,6,421,5,416,131,127,87,34,13,7,0,0,2,2,0,1,1,1,0,0,5,1,4
1740,112,600,202,398,4,394,0,394,143,121,74,23,17,4,2,0,1,1,0,0,0,1,0,2,2,1,2
1741,112,871,241,630,5,625,6,619,250,159,103,48,31,11,0,1,0,0,0,0,1,0,3,2,3,0,7
1742,112,1002,366,636,10,626,6,620,204,186,142,35,35,8,0,0,0,2,0,1,1,0,0,0,3,0,3
1743,112,1017,412,605,1,604,6,598,177,176,138,40,39,16,0,0,1,0,0,0,0,0,2,0,2,2,5
1744,112,697,288,409,6,403,4,399,155,87,81,37,22,9,0,0,0,0,0,0,0,0,0,1,2,2,3
1745,112,713,235,478,3,475,1,474,113,148,110,49,32,9,0,1,1,0,0,0,0,0,0,0,8,0,3
1746,112,745,341,404,6,398,2,396,133,105,90,33,18,7,0,0,0,0,1,0,0,0,0,2,1,2,4
1747,112,901,376,525,8,517,2,515,153,147,116,46,26,12,0,0,0,1,0,0,0,0,0,0,9,0,5
1748,112,751,272,479,2,477,8,469,182,143,79,38,13,5,0,1,0,0,0,0,2,0,0,0,5,0,1
1749,112,560,184,376,5,371,6,365,110,96,88,41,15,3,0,0,0,0,0,0,0,0,3,6,1,2,0
1750,112,598,185,413,5,408,2,406,109,127,72,43,23,14,2,0,0,0,0,0,0,2,1,1,7,1,4
1751,112,603,235,368,4,364,4,360,103,131,67,25,27,2,0,0,0,0,0,0,0,0,0,0,4,0,1
1752,112,851,388,463,5,458,3,455,126,125,132,30,22,5,0,1,0,0,1,1,0,2,3,0,4,1,2
1753,112,795,297,498,2,496,7,489,154,135,115,44,18,9,0,0,1,0,1,0,3,0,1,2,2,1,3
1754,112,802,269,533,7,526,2,524,195,137,104,48,14,9,0,1,0,1,0,0,0,1,1,1,5,0,7
1755,112,693,156,537,6,531,6,525,158,148,92,72,29,10,0,1,0,0,0,1,2,0,0,0,8,1,3
1756,112,741,182,559,3,556,3,553,160,151,111,72,36,11,1,0,0,0,0,2,3,0,0,1,3,0,2
1757,112,629,173,456,6,450,2,448,146,115,97,46,19,8,0,0,0,0,1,1,3,0,1,0,0,0,11
1758,112,626,222,404,1,403,2,401,145,101,81,34,18,18,0,0,1,0,0,0,0,0,0,0,1,1,1
1759,112,791,251,540,3,537,4,533,155,180,104,42,29,10,0,0,0,0,0,0,0,1,0,1,3,1,7
1760,112,907,219,688,7,681,11,670,223,153,121,92,40,17,0,1,0,0,0,2,0,0,0,0,2,3,16
1761,113,903,323,580,5,575,8,567,153,192,114,37,42,8,1,0,2,0,1,3,0,0,1,1,8,2,2
1762,113,562,256,306,6,300,0,300,79,95,66,22,17,5,0,0,0,0,0,0,0,0,0,5,6,0,5
1763,113,609,266,343,0,343,1,342,87,72,108,28,22,4,0,0,0,0,0,0,0,0,1,1,7,1,11
1764,113,693,216,477,4,473,4,469,163,114,92,49,27,11,0,0,0,0,0,1,0,0,1,1,4,0,6
1765,113,734,203,531,5,526,5,521,195,133,100,46,22,9,0,0,0,0,0,2,0,2,2,0,5,2,3
1766,113,924,286,638,5,633,13,620,225,154,108,47,43,4,0,1,0,1,0,3,0,0,3,1,6,0,24
1767,113,582,141,441,4,437,3,434,157,126,87,23,24,3,0,0,0,1,0,0,0,0,0,2,4,1,6
1768,113,525,154,371,0,371,3,368,146,87,65,25,19,10,0,0,0,0,0,1,1,1,0,0,6,0,7
1769,113,895,509,386,1,385,2,383,71,125,116,23,32,8,0,0,0,1,0,0,0,0,0,1,6,0,0
1770,113,891,385,506,3,503,6,497,126,182,99,39,25,15,1,1,0,0,1,0,1,0,0,0,4,0,3
1771,113,739,306,433,5,428,1,427,128,130,89,40,17,9,0,0,0,0,2,0,0,3,0,0,3,0,6
1772,113,670,254,416,4,412,6,406,123,133,66,38,22,9,1,2,0,1,0,0,0,0,1,0,8,1,1
1773,113,560,202,358,5,353,3,350,87,133,74,27,14,11,0,0,0,0,0,0,0,0,1,1,2,0,0
1774,113,852,332,520,1,519,5,514,144,164,113,47,24,11,0,0,0,0,0,0,0,1,1,2,6,1,0
1775,113,978,281,697,9,688,10,678,157,197,214,37,48,10,1,0,0,0,0,0,0,0,0,3,8,0,3
1776,113,661,288,373,0,373,0,373,98,109,98,33,19,2,1,0,1,0,0,0,0,1,0,0,6,2,3
1777,113,462,189,273,1,272,2,270,63,86,74,24,16,4,0,0,1,0,0,0,0,0,0,0,0,1,1
1778,113,539,225,314,3,311,5,306,73,93,84,14,21,9,0,0,0,0,0,2,1,0,2,0,4,0,3
1779,113,758,286,472,5,467,6,461,134,143,101,43,24,6,0,0,0,1,0,0,0,0,0,1,6,0,2
1780,113,789,328,461,1,460,4,456,107,138,120,39,27,10,1,0,0,0,0,0,0,0,3,2,4,0,5
1781,113,634,210,424,3,421,6,415,115,106,87,60,30,9,0,0,0,0,0,0,1,0,1,1,2,0,3
1782,113,570,194,376,11,365,3,362,120,92,75,45,12,11,0,0,0,0,0,0,0,1,0,1,4,0,1
1783,113,569,255,314,0,314,0,314,76,101,83,18,17,3,0,0,1,0,0,3,3,0,0,1,4,0,4
1784,113,620,203,417,0,417,6,411,110,108,92,59,22,12,0,0,0,0,0,0,0,0,0,0,1,0,7
1785,113,706,198,508,4,504,6,498,136,145,90,70,29,14,0,0,0,0,0,0,0,0,0,2,4,0,8
1786,113,695,227,468,3,465,5,460,147,118,92,56,22,13,0,0,0,0,0,0,1,1,1,1,1,0,7
1787,113,871,309,562,4,558,3,555,192,160,103,46,25,11,0,0,0,0,1,1,0,1,2,0,8,1,4
1788,113,692,259,433,6,427,5,422,157,112,83,24,20,7,2,0,0,1,0,2,0,1,1,1,6,2,3
1789,113,744,281,463,5,458,3,455,166,139,86,31,16,6,1,1,0,0,0,0,2,1,0,1,1,2,2
1790,113,666,258,408,7,401,5,396,101,144,67,45,11,10,2,0,0,0,0,0,0,0,0,1,9,2,4
1791,113,698,276,422,4,418,2,416,106,144,95,27,9,16,0,0,0,2,0,0,0,1,1,5,6,1,3
1792,113,627,256,371,11,360,4,356,81,136,80,15,22,11,0,0,0,0,0,0,0,0,0,1,5,1,4
1793,113,646,236,410,6,404,5,399,71,149,100,37,17,13,1,0,0,1,0,1,1,2,0,1,1,0,4
1794,113,982,393,589,7,582,3,579,172,206,111,39,22,11,1,1,1,2,0,1,0,2,0,1,6,0,3
1795,113,816,360,456,6,450,4,446,142,127,99,40,22,5,0,0,0,2,0,0,0,0,0,1,8,0,0
1796,113,557,226,331,5,326,5,321,110,90,75,20,13,3,2,0,2,0,1,0,1,1,1,0,2,0,0
1797,113,666,173,493,2,491,8,483,200,130,65,46,23,11,0,0,0,0,0,0,0,2,0,0,5,0,1
1798,113,507,287,220,2,218,2,216,31,87,64,15,10,2,2,0,0,0,0,0,0,0,0,0,3,1,1
1799,113,536,291,245,1,244,2,242,57,83,54,12,17,2,2,0,0,0,0,0,0,0,0,2,9,0,4
1800,114,898,352,546,3,543,6,537,184,147,110,44,19,11,2,0,0,0,0,0,1,0,0,1,3,1,14
1801,114,630,239,391,0,391,0,391,134,112,78,33,26,1,0,1,0,0,0,0,0,1,0,2,2,0,1
1802,114,559,236,323,3,320,3,317,94,113,52,24,24,4,0,0,1,1,0,1,0,0,1,0,2,0,0
1803,114,536,229,307,3,304,4,300,93,93,66,24,13,4,1,0,1,0,0,0,0,0,1,0,2,2,0
1804,114,601,247,354,5,349,1,348,116,113,55,31,14,8,1,0,0,0,0,1,0,0,2,1,2,1,3
1805,114,534,234,300,4,296,3,293,110,74,55,32,10,7,1,0,0,0,0,1,1,0,0,0,2,0,0
1806,114,715,316,399,4,395,1,394,143,87,82,35,23,11,0,0,0,0,0,1,1,2,0,0,2,2,5
1807,114,582,259,323,5,318,0,318,112,91,65,34,13,2,0,0,0,0,0,0,0,0,0,0,1,0,0
1808,114,516,192,324,4,320,2,318,111,84,70,25,15,3,1,0,0,0,0,0,1,1,0,0,1,0,6
1809,114,925,402,523,8,515,3,512,147,156,112,52,21,6,1,0,0,1,1,2,3,2,0,1,3,2,2
1810,114,703,283,420,8,412,2,410,165,112,55,40,11,6,0,0,0,1,0,1,0,0,0,0,15,0,4
1811,114,950,421,529,7,522,9,513,154,129,132,40,28,13,1,0,0,1,0,1,0,1,0,2,5,2,4
1812,114,523,191,332,2,330,2,328,102,99,69,32,17,4,0,0,0,0,0,0,0,1,0,1,3,0,0
1813,114,551,219,332,4,328,3,325,81,109,76,32,15,6,0,0,0,0,0,0,0,0,0,0,3,0,3
1814,114,624,233,391,4,387,0,387,134,110,75,40,19,5,0,0,0,0,0,0,0,1,0,0,2,1,0
1815,114,668,252,416,5,411,3,408,132,131,64,45,21,5,1,1,0,0,0,1,1,0,0,1,2,2,1
1816,114,969,377,592,5,587,9,578,187,150,136,59,20,17,1,0,0,1,0,1,0,0,1,1,2,0,2
1817,114,797,265,532,3,529,3,526,138,175,119,41,30,14,0,0,0,0,0,0,0,0,0,1,7,0,1
1818,114,535,168,367,5,362,2,360,157,94,41,34,16,6,1,0,0,0,0,0,0,1,1,0,7,0,2
1819,114,509,154,355,4,351,2,349,130,111,50,40,6,4,0,0,0,0,0,1,0,0,0,0,5,0,2
1820,114,617,157,460,4,456,6,450,206,116,47,49,13,8,0,0,0,0,0,0,0,0,0,0,2,0,9
1821,114,665,181,484,2,482,3,479,218,108,51,53,19,13,0,0,0,0,0,1,0,0,0,2,4,1,9
1822,114,535,124,411,1,410,2,408,129,118,81,40,17,9,0,0,0,0,0,0,0,0,1,0,7,1,5
1823,114,523,99,424,1,423,6,417,116,127,75,50,26,8,0,0,0,0,1,0,0,0,0,0,4,3,7
1824,114,781,166,615,9,606,6,600,235,181,81,57,14,16,0,2,1,0,1,0,0,1,0,0,4,0,7
1825,114,891,222,669,6,663,11,652,269,156,123,54,20,13,0,0,0,0,1,0,0,0,2,1,5,1,7
1826,114,530,154,376,1,375,6,369,126,111,42,42,26,8,0,0,0,1,0,0,0,0,0,0,5,1,7
1827,114,567,161,406,9,397,3,394,129,104,78,34,18,7,2,1,0,0,0,0,0,0,2,0,5,0,14
1828,114,824,194,630,9,621,2,619,227,187,92,51,28,14,0,1,0,1,0,1,0,0,0,0,5,1,11
1829,114,805,303,502,2,500,9,491,151,148,99,47,22,12,1,0,0,2,0,1,1,0,0,0,1,1,5
1830,114,739,295,444,3,441,0,441,124,137,97,43,19,7,0,0,0,0,0,0,2,1,0,3,4,0,4
1831,114,591,213,378,5,373,2,371,121,97,85,37,18,6,0,1,0,0,0,0,0,0,2,1,1,0,2
1832,114,661,249,412,4,408,2,406,119,112,93,46,20,9,0,1,0,0,0,0,0,0,1,1,3,0,1
1833,114,985,342,643,6,637,7,630,195,205,118,49,36,8,0,0,0,0,0,0,0,1,1,1,9,4,3
1834,114,567,210,357,4,353,0,353,110,115,68,32,13,4,0,1,0,0,0,0,0,0,0,0,3,0,7
1835,114,596,224,372,5,367,2,365,117,106,80,30,20,4,0,1,0,0,0,0,0,0,0,0,2,1,4
1836,114,806,307,499,3,496,8,488,215,120,69,43,19,10,0,0,0,0,0,2,0,0,0,2,5,0,3
1837,114,561,227,334,3,331,2,329,125,103,56,24,9,1,0,1,0,0,0,0,0,0,0,0,2,0,8
1838,114,631,232,399,1,398,5,393,150,101,76,28,13,8,0,0,0,1,0,0,1,0,0,1,9,0,5
1839,114,861,285,576,4,572,3,569,237,185,68,39,19,9,1,0,0,1,1,2,0,1,1,0,2,1,2
1840,114,826,313,513,4,509,1,508,178,137,102,44,26,8,0,0,0,0,0,0,0,0,1,2,2,1,7
1841,114,844,364,480,6,474,3,471,166,161,76,32,15,12,0,0,0,0,1,1,0,0,1,1,2,1,2
1842,114,771,345,426,12,414,3,411,121,129,87,40,14,12,0,0,0,0,0,0,0,4,0,0,0,1,3
1843,114,717,295,422,4,418,6,412,116,141,90,34,8,8,1,0,0,0,0,3,0,0,0,4,7,0,0
1844,114,880,293,587,5,582,9,573,225,153,96,37,30,13,3,0,0,0,0,0,1,2,1,1,5,1,5
1845,114,723,232,491,3,488,0,488,142,142,103,37,28,14,2,0,0,0,0,1,0,1,1,1,10,2,4
1846,115,981,387,594,4,590,5,585,197,183,85,59,26,15,2,1,0,1,0,1,0,0,1,0,9,1,4
1847,115,873,306,567,3,564,8,556,176,169,116,48,26,14,1,0,0,0,0,0,0,1,0,0,0,2,3
1848,115,580,231,349,2,347,1,346,110,97,69,22,24,12,0,0,0,0,0,0,1,0,0,0,6,2,3
1849,115,678,282,396,5,391,5,386,130,98,81,46,16,5,0,1,0,0,0,2,1,0,0,1,5,0,0
1850,115,552,187,365,4,361,3,358,112,110,75,33,15,3,0,2,0,0,0,0,0,1,1,0,5,1,0
1851,115,560,247,313,6,307,6,301,78,85,91,17,18,4,0,0,0,1,0,0,0,0,1,1,4,1,0
1852,115,527,244,283,2,281,6,275,56,110,59,23,14,6,1,2,1,0,0,0,1,0,0,0,2,0,0
1853,115,775,326,449,5,444,3,441,116,135,104,36,36,4,0,0,0,0,0,0,0,2,0,0,3,2,3
1854,115,805,368,437,4,433,3,430,148,126,88,26,24,5,0,2,0,0,0,1,0,1,0,0,8,0,1
1855,115,729,318,411,1,410,7,403,128,131,68,35,22,8,1,0,0,0,0,2,0,0,0,2,3,1,2
1856,115,869,386,483,2,481,7,474,115,179,98,27,32,8,0,0,1,0,0,0,0,1,0,1,1,0,11
1857,115,621,283,338,0,338,7,331,89,121,47,34,14,11,2,0,1,0,0,0,0,2,1,1,7,1,0
1858,115,738,507,231,4,227,3,224,68,69,41,26,11,5,0,0,0,0,0,0,1,0,1,0,1,0,1
1859,115,560,172,388,7,381,1,380,133,89,71,55,14,10,0,0,0,0,0,0,0,0,0,0,5,0,3
1860,115,580,174,406,2,404,6,398,138,108,60,57,19,6,1,0,1,0,0,0,0,1,0,1,3,0,3
1861,115,531,154,377,6,371,3,368,114,102,76,46,19,3,0,0,0,1,0,0,0,2,0,0,2,0,3
1862,115,533,160,373,1,372,6,366,126,91,82,41,14,6,0,0,0,0,0,0,0,0,1,0,3,0,2
1863,115,1000,312,688,5,683,5,678,170,209,145,83,41,14,1,0,0,0,0,0,0,2,0,2,5,2,4
1864,115,904,278,626,9,617,8,609,168,174,128,79,36,13,1,1,0,0,0,0,0,3,0,0,3,0,3
1865,115,783,361,422,2,420,2,418,90,168,96,23,22,4,1,1,1,1,1,0,0,0,4,3,1,1,1
1866,115,774,436,338,6,332,2,330,56,122,96,26,12,3,1,0,0,0,0,1,0,0,3,1,9,0,0
1867,115,549,268,281,0,281,0,281,53,107,70,25,15,6,1,0,0,1,0,0,0,1,2,0,0,0,0
1868,115,568,278,290,3,287,2,285,63,102,69,24,16,3,0,0,0,0,0,1,1,1,0,0,3,0,2
1869,115,617,291,326,7,319,5,314,77,116,69,30,8,4,0,0,0,0,0,0,0,3,0,4,2,1,0
1870,115,565,291,274,4,270,4,266,70,79,50,28,19,13,1,0,0,0,0,0,0,0,0,1,4,0,1
1871,115,773,247,526,0,526,6,520,186,152,78,48,22,16,0,0,0,0,0,0,0,0,0,4,9,1,4
1872,115,578,178,400,5,395,2,393,110,124,89,28,25,6,1,0,0,1,0,0,0,1,0,2,3,0,3
1873,115,685,227,458,3,455,3,452,139,142,87,34,19,16,0,0,1,0,0,1,0,1,0,0,4,3,5
1874,115,877,337,540,6,534,3,531,188,151,86,52,24,8,0,0,0,0,1,0,0,3,5,1,4,2,6
1875,115,772,223,549,6,543,4,539,157,176,96,59,22,9,1,1,0,0,1,0,4,2,3,1,4,0,3
1876,115,735,265,470,3,467,5,462,151,134,77,58,19,13,0,1,0,0,0,0,2,0,0,0,6,0,1
1877,115,583,172,411,5,406,6,400,127,107,74,51,15,16,3,1,0,0,0,1,1,0,0,2,1,1,0
1878,115,531,132,399,1,398,8,390,151,107,56,44,13,5,1,0,1,0,0,0,2,0,0,1,2,0,7
1879,116,709,269,440,8,432,3,429,103,151,87,39,24,10,0,0,0,0,0,1,1,0,0,1,6,2,4
1880,116,539,217,322,3,319,5,314,128,93,49,20,13,2,0,0,0,0,0,0,0,1,0,2,4,0,2
1881,116,497,185,312,3,309,3,306,114,78,66,16,15,6,1,0,0,0,0,0,0,0,0,1,5,0,4
1882,116,964,385,579,9,570,5,565,167,154,145,56,24,6,1,1,0,0,0,1,0,2,1,0,3,0,4
1883,116,852,274,578,6,572,6,566,200,161,103,49,26,9,1,0,0,1,1,0,3,1,1,2,4,1,3
1884,116,526,153,373,4,369,2,367,111,111,77,45,13,5,0,0,0,0,0,0,0,0,0,0,0,1,4
1885,116,941,379,562,3,559,4,555,107,229,139,30,20,10,0,0,0,0,0,3,1,1,0,1,10,2,2
1886,116,941,348,593,3,590,7,583,159,167,139,52,35,15,1,0,0,0,0,1,1,1,0,0,7,0,5
1887,116,497,182,315,3,312,4,308,111,96,56,17,13,3,0,0,0,0,0,0,0,0,0,2,6,0,4
1888,116,515,182,333,3,330,6,324,108,92,49,33,13,10,1,0,1,0,0,2,0,1,1,2,3,1,7
1889,116,654,175,479,5,474,7,467,115,175,98,29,33,11,0,1,0,1,0,1,0,0,0,0,2,0,1
1890,116,576,156,420,2,418,6,412,93,144,104,30,23,7,1,0,0,2,0,1,0,0,1,0,4,0,2
1891,116,775,273,502,4,498,6,492,129,160,114,51,22,6,0,1,1,0,1,0,0,0,2,1,2,1,1
1892,116,764,269,495,3,492,3,489,114,137,145,45,20,12,0,0,0,0,0,0,0,3,0,3,8,1,1
1893,116,677,282,395,3,392,3,389,114,136,78,24,12,16,0,0,0,0,0,0,0,0,0,0,6,1,2
1894,116,867,299,568,7,561,8,553,146,171,109,62,33,8,1,1,0,0,0,0,0,1,1,1,5,0,14
1895,116,809,308,501,7,494,3,491,125,151,125,40,29,3,1,1,0,0,0,2,0,1,1,2,5,0,5
1896,116,726,213,513,3,510,6,504,147,145,120,50,23,5,0,1,0,0,1,1,0,1,0,1,6,1,2
1897,116,794,197,597,12,585,3,582,165,168,133,57,30,9,0,1,0,0,0,1,0,2,0,1,10,1,4
1898,116,526,207,319,2,317,3,314,113,86,65,24,13,7,0,0,0,0,0,0,1,0,0,0,4,0,1
1899,116,538,185,353,0,353,4,349,109,92,78,35,18,7,0,0,1,0,0,0,2,0,0,0,7,0,0
1900,116,780,286,494,3,491,3,488,148,130,110,45,27,13,3,0,0,0,0,0,0,2,3,2,4,1,0
1901,116,801,237,564,13,551,6,545,109,155,138,87,26,20,0,0,1,1,0,0,0,0,1,0,4,1,2
1902,116,766,219,547,1,546,0,546,118,147,142,68,32,22,0,0,2,0,2,0,2,1,0,1,7,0,2
1903,116,785,168,617,1,616,4,612,142,168,112,122,39,19,0,0,0,0,0,1,0,0,0,0,5,0,4
1904,116,715,152,563,9,554,7,547,131,137,106,126,22,21,0,0,0,0,0,0,1,0,0,0,0,1,2
1905,116,529,165,364,2,362,4,358,69,99,97,57,23,9,0,0,0,0,0,0,1,0,1,0,0,2,0
1906,116,561,127,434,3,431,3,428,78,110,121,62,32,11,0,0,1,0,1,2,0,0,0,0,5,2,3
1907,116,904,192,712,6,706,5,701,125,174,179,142,45,28,0,0,0,0,0,0,0,1,0,1,3,0,3
1908,116,983,240,743,13,730,16,714,165,194,140,140,33,22,0,0,0,0,0,2,0,1,1,4,11,0,1
1909,116,605,111,494,5,489,4,485,113,127,85,107,13,21,0,0,2,0,0,0,0,1,1,3,4,2,6
1910,116,585,127,458,2,456,11,445,104,123,82,101,13,13,0,0,1,0,0,0,0,2,0,0,3,0,3
1911,116,698,212,486,5,481,5,476,82,142,118,83,24,11,0,0,0,0,0,1,1,0,1,1,12,0,0
1912,116,737,227,510,4,506,4,502,98,143,116,85,28,15,0,0,0,0,0,0,0,3,4,0,6,2,2
1913,116,587,156,431,7,424,5,419,99,120,85,74,17,10,0,1,0,0,0,0,0,1,0,1,3,1,7
1914,116,761,205,556,4,552,7,545,125,151,120,104,21,11,0,0,1,1,1,0,0,0,0,1,3,1,5
1915,116,686,185,501,4,497,7,490,117,117,119,99,21,13,0,0,0,0,0,0,0,0,0,0,1,0,3
1916,116,673,163,510,9,501,7,494,122,135,103,87,26,12,0,0,0,0,0,0,1,1,0,0,4,0,3
1917,116,693,152,541,4,537,9,528,144,129,118,99,17,12,0,0,0,1,1,1,0,0,1,1,3,0,1
1918,116,882,232,650,6,644,7,637,154,161,130,136,27,19,0,0,1,0,0,0,0,1,0,1,0,3,4
1919,116,964,268,696,6,690,10,680,183,166,138,126,34,19,0,0,1,0,0,0,1,1,0,0,7,0,4
1920,116,935,421,514,7,507,6,501,135,156,111,56,26,6,1,0,1,0,0,0,0,0,0,0,5,0,4
1921,117,880,386,494,2,492,0,492,116,154,121,42,16,10,2,2,0,0,0,0,0,2,6,6,12,2,1
1922,117,885,522,363,1,362,5,357,75,139,88,17,21,7,1,0,0,0,0,0,0,0,2,1,1,2,3
1923,117,513,266,247,2,245,2,243,59,95,52,11,15,5,0,0,0,1,0,0,0,3,1,0,0,0,1
1924,117,597,298,299,6,293,3,290,59,129,60,15,20,2,1,0,0,0,0,0,0,1,0,1,1,0,1
1925,117,735,368,367,4,363,2,361,81,137,90,22,8,8,1,0,1,0,1,0,4,1,0,0,5,0,2
1926,117,525,199,326,2,324,3,321,88,108,68,31,14,5,1,0,0,0,0,0,0,0,0,2,3,0,1
1927,117,561,170,391,1,390,3,387,137,119,65,34,11,9,0,1,0,0,0,2,0,1,0,1,4,0,3
1928,117,547,170,377,4,373,3,370,130,125,54,24,19,6,0,0,0,0,2,0,0,0,0,0,6,0,4
1929,117,639,240,399,3,396,2,394,123,149,56,27,18,9,2,0,0,0,0,1,1,0,0,1,6,1,0
1930,117,630,221,409,3,406,2,404,124,127,77,34,23,6,0,0,0,0,0,0,0,1,2,0,1,1,8
1931,117,751,273,478,3,475,3,472,164,134,97,40,18,11,1,0,0,0,0,0,0,1,0,1,2,0,3
1932,117,776,228,548,1,547,4,543,213,156,84,50,27,8,0,0,0,0,1,0,0,0,0,0,1,0,3
1933,117,764,259,505,2,503,4,499,141,157,97,52,20,8,0,0,0,1,0,2,1,2,2,2,13,1,0
1934,117,845,335,510,1,509,8,501,134,154,129,40,17,8,0,0,0,0,1,0,0,1,2,1,7,1,6
1935,117,635,279,356,4,352,5,347,102,94,67,42,19,9,0,1,0,0,2,2,0,2,0,1,4,1,1
1936,117,584,241,343,1,342,4,338,87,124,71,23,22,4,1,0,0,0,0,1,0,1,1,0,0,0,3
1937,117,797,313,484,3,481,5,476,167,133,98,38,17,12,0,2,0,0,0,0,0,0,0,1,4,1,3
1938,117,576,198,378,8,370,8,362,128,110,57,31,15,9,1,1,0,0,0,1,0,0,2,1,3,1,2
1939,117,1022,356,666,10,656,5,651,212,195,144,44,29,17,0,0,0,1,0,0,0,0,0,0,3,3,3
1940,117,776,294,482,7,475,6,469,139,138,101,47,28,7,1,0,0,1,1,0,0,0,1,1,2,1,1
1941,117,796,322,474,1,473,7,466,152,128,94,45,28,5,1,0,0,0,0,2,2,1,1,0,6,0,1
1942,117,825,314,511,3,508,4,504,138,139,125,50,31,8,0,0,1,0,0,1,0,1,0,0,3,1,6
1943,117,587,251,336,1,335,1,334,109,88,80,24,8,10,0,0,0,1,1,0,0,1,1,2,2,2,5
1944,117,858,186,672,4,668,7,661,181,172,108,130,25,19,0,0,0,0,1,0,2,3,1,0,12,1,6
1945,117,938,187,751,6,745,19,726,217,210,110,128,24,11,1,0,0,1,1,0,1,2,0,2,4,5,9
1946,117,736,176,560,5,555,7,548,173,137,80,113,26,8,0,0,0,1,0,0,1,0,1,2,2,0,4
1947,117,803,204,599,2,597,10,587,173,142,98,125,16,15,0,0,0,1,0,2,1,0,1,3,6,0,4
1948,117,725,166,559,3,556,9,547,160,138,96,94,23,23,0,1,0,0,0,0,2,0,0,0,5,2,3
1949,121,575,177,398,1,397,2,395,72,120,123,35,23,15,0,1,0,0,1,1,0,1,2,0,0,1,0
1950,121,622,182,440,2,438,5,433,99,144,128,24,19,7,1,0,0,0,0,0,0,1,0,0,6,1,3
1951,121,980,332,648,5,643,3,640,157,234,139,34,43,19,1,0,0,1,0,0,0,0,1,0,8,2,1
1952,121,847,252,595,6,589,3,586,129,213,150,47,26,7,2,0,0,0,0,0,0,2,1,0,4,1,4
1953,121,595,160,435,6,429,3,426,104,143,107,31,25,4,0,0,0,0,0,0,0,0,3,2,7,0,0
1954,121,564,146,418,0,418,2,416,90,147,123,22,26,4,0,0,0,0,1,0,1,0,0,0,2,0,0
1955,121,556,167,389,5,384,2,382,82,136,110,23,16,9,0,0,0,0,0,0,0,0,0,0,6,0,0
1956,121,943,378,565,9,556,4,552,108,184,150,45,40,13,1,1,0,0,1,0,0,0,0,2,5,0,2
1957,121,898,288,610,8,602,2,600,74,261,153,38,49,8,0,0,1,0,0,0,0,3,3,0,9,1,0
1958,121,736,212,524,1,523,0,523,47,224,156,23,54,7,0,0,0,2,0,2,1,0,0,0,5,0,2
1959,121,784,271,513,6,507,1,506,52,199,171,29,33,11,0,1,0,0,0,0,1,2,0,2,3,0,2
1960,121,814,299,515,5,510,3,507,63,239,121,35,36,2,1,0,0,0,0,0,0,0,0,0,8,0,2
1961,121,766,252,514,2,512,6,506,70,221,135,29,28,7,2,1,0,1,0,2,0,2,6,0,1,1,0
1962,121,912,320,592,2,590,3,587,64,216,191,51,40,12,1,1,0,0,0,0,0,0,0,1,6,1,3
1963,121,921,333,588,6,582,0,582,57,292,144,30,31,15,1,0,0,1,1,0,0,0,2,0,8,0,0
1964,121,609,167,442,5,437,5,432,76,166,108,50,15,5,2,2,0,0,1,0,0,0,0,0,5,0,2
1965,121,609,193,416,7,409,3,406,77,150,76,58,26,7,1,0,0,0,0,0,0,0,2,0,5,0,4
1966,121,616,153,463,1,462,4,458,85,113,126,79,20,14,1,3,0,0,1,0,0,1,2,3,4,3,3
1967,121,588,150,438,8,430,6,424,81,120,105,80,14,12,0,0,1,0,0,0,0,1,1,1,5,2,1
1968,121,736,254,482,4,478,5,473,92,124,124,70,32,11,1,1,0,1,0,0,0,1,1,1,8,2,4
1969,121,838,241,597,1,596,11,585,106,160,166,83,41,10,1,0,0,1,0,1,0,1,0,1,9,1,4
1970,121,718,187,531,10,521,7,514,119,136,111,96,28,6,0,1,1,0,0,0,1,1,0,2,6,3,3
1971,121,723,191,532,6,526,13,513,134,135,98,101,16,15,0,0,0,0,0,0,0,1,1,2,3,3,4
1972,122,694,337,357,1,356,5,351,48,134,122,16,20,5,0,0,0,0,0,0,2,0,1,1,1,0,1
1973,122,724,323,401,3,398,2,396,46,155,127,27,23,5,0,0,0,1,0,0,0,2,2,1,7,0,0
1974,122,876,499,377,3,374,2,372,45,159,110,16,23,5,0,0,0,0,0,1,0,2,2,1,7,1,0
1975,122,948,408,540,11,529,4,525,91,215,119,40,32,7,2,1,0,0,2,0,0,5,0,1,6,2,2
1976,122,525,186,339,4,335,1,334,103,144,44,18,14,6,0,0,0,0,0,0,0,0,1,1,3,0,0
1977,122,556,296,260,3,257,3,254,40,132,47,10,17,4,0,0,0,0,0,0,0,2,0,1,0,1,0
1978,122,527,223,304,4,300,3,297,35,119,95,16,17,7,0,0,1,0,0,0,0,0,0,1,4,2,0
1979,122,577,216,361,3,358,3,355,52,134,111,21,22,4,0,0,0,0,0,0,2,2,0,0,5,2,0
1980,122,712,263,449,4,445,7,438,104,135,92,49,26,13,1,0,0,0,0,1,0,3,0,0,8,1,5
1981,122,764,286,478,5,473,8,465,86,143,124,60,23,12,3,0,1,0,0,1,0,0,0,2,5,1,4
1982,122,947,381,566,4,562,6,556,108,199,164,34,33,5,1,0,0,0,0,0,0,0,1,1,8,1,1
1983,122,967,375,592,3,589,4,585,128,154,162,83,24,13,0,0,0,0,3,1,0,4,1,1,3,3,5
1984,122,742,280,462,7,455,5,450,76,130,124,70,22,13,1,0,1,0,1,0,0,0,2,0,7,0,3
1985,123,542,199,343,0,343,4,339,80,105,79,45,15,4,0,1,0,0,0,0,0,0,1,4,4,0,1
1986,123,575,209,366,0,366,11,355,103,106,70,50,12,5,0,0,1,0,0,0,0,1,0,0,2,2,3
1987,123,625,219,406,0,406,3,403,117,149,89,24,13,6,0,0,0,0,0,0,2,1,0,1,1,0,0
1988,123,809,380,429,6,423,1,422,110,164,81,35,22,1,1,1,0,1,0,0,0,0,2,1,3,0,0
1989,123,806,332,474,3,471,2,469,128,159,105,24,25,12,0,0,2,0,0,0,0,3,0,2,6,0,3
1990,123,546,227,319,2,317,0,317,97,108,69,23,10,3,0,0,0,1,0,1,0,1,0,0,3,1,0
1991,123,941,334,607,9,598,10,588,141,195,134,52,35,11,0,2,0,0,0,1,0,2,0,4,5,0,6
1992,123,989,327,662,11,651,5,646,164,191,154,71,30,10,4,0,0,0,0,0,1,4,1,3,10,0,3
1993,123,881,316,565,6,559,3,556,152,168,142,40,30,9,1,0,0,1,0,0,0,2,1,2,4,1,3
1994,123,959,390,569,4,565,6,559,120,158,163,40,43,16,1,0,0,0,1,0,0,2,0,1,8,4,2
1995,123,507,217,290,4,286,3,283,44,117,70,21,13,9,2,0,0,0,1,0,0,0,0,0,5,0,1
1996,123,555,238,317,4,313,8,305,55,117,88,17,13,4,0,0,0,0,1,1,1,1,2,0,3,0,2
1997,123,543,241,302,2,300,2,298,53,109,84,15,19,3,1,1,0,0,0,0,0,0,4,3,5,0,1
1998,123,610,255,355,1,354,3,351,84,124,94,25,13,3,1,0,0,0,0,0,0,0,0,0,3,0,4
1999,123,560,224,336,3,333,3,330,52,126,104,19,16,2,0,1,0,0,1,1,1,0,0,1,4,0,2
2000,123,715,294,421,2,419,4,415,64,149,112,48,26,6,0,0,0,0,0,1,0,0,0,1,4,1,3
2001,123,784,334,450,3,447,5,442,78,128,137,46,31,4,1,0,0,0,0,1,0,1,0,0,5,1,9
2002,123,513,178,335,0,335,4,331,88,84,71,60,13,8,0,0,0,0,0,0,0,0,0,0,4,0,3
2003,123,537,168,369,3,366,2,364,109,81,78,47,28,13,0,0,0,0,2,0,0,0,0,0,4,0,2
2004,123,962,285,677,7,670,15,655,172,165,160,91,28,21,2,0,0,1,0,0,0,0,1,1,4,4,5
2005,123,593,200,393,9,384,6,378,94,115,85,47,22,7,0,0,0,0,0,0,0,1,1,1,2,2,1
2006,123,603,218,385,2,383,4,379,93,117,84,55,15,8,1,0,0,0,1,0,0,0,0,1,1,2,1
2007,124,749,313,436,1,435,0,435,110,180,85,20,21,4,0,1,0,1,2,2,0,2,0,1,5,0,1
2008,124,535,216,319,5,314,1,313,55,132,76,20,17,6,0,0,0,1,1,1,0,0,0,1,2,0,1
2009,124,515,233,282,0,282,2,280,64,122,57,13,9,6,1,0,1,0,1,1,0,0,0,0,2,0,3
2010,124,684,331,353,3,350,2,348,106,116,84,14,14,2,0,0,0,0,1,1,0,0,0,1,3,0,6
2011,124,885,370,515,6,509,1,508,150,176,105,35,26,5,2,0,0,0,0,0,0,0,0,2,1,4,2
2012,124,956,392,564,3,561,8,553,166,189,95,50,21,9,0,2,2,0,1,3,0,0,0,1,12,0,2
2013,124,901,421,480,2,478,5,473,131,154,87,53,20,7,0,0,0,1,3,1,0,0,0,3,12,0,1
2014,124,924,431,493,5,488,1,487,122,152,123,35,31,14,0,0,0,0,0,1,0,0,0,0,3,1,5
2015,124,588,241,347,5,342,3,339,94,111,81,32,9,4,3,1,0,0,1,1,0,0,0,0,2,0,0
2016,124,940,425,515,5,510,7,503,153,137,104,0,1,56,1,0,0,2,6,1,27,0,2,0,6,2,5
2017,124,563,236,327,3,324,3,321,108,82,67,24,8,9,1,0,0,0,0,2,0,2,1,1,12,0,4
2018,124,531,230,301,0,301,1,300,104,80,67,24,11,6,0,0,0,0,0,0,0,1,0,0,4,2,1
2019,124,930,413,517,3,514,3,511,179,146,104,36,29,4,0,0,0,2,1,2,2,0,0,0,3,2,1
2020,124,922,406,516,2,514,3,511,153,148,131,34,22,7,0,0,0,0,0,0,0,0,5,0,5,0,6
2021,124,887,350,537,0,537,5,532,160,164,96,66,22,9,0,0,1,0,0,4,0,1,0,2,3,1,3
2022,124,753,200,553,4,549,8,541,177,139,93,83,29,9,0,0,0,0,0,0,0,0,2,0,3,1,5
2023,124,802,220,582,6,576,2,574,166,183,80,92,30,15,0,0,0,1,0,0,0,1,0,0,3,0,3
2024,125,840,228,612,6,606,6,600,234,143,96,79,22,10,0,0,0,0,0,0,0,2,2,0,4,1,7
2025,125,789,223,566,7,559,7,552,220,137,92,63,24,10,0,0,0,0,0,0,0,0,0,0,1,0,5
2026,125,537,160,377,4,373,5,368,159,85,49,37,19,9,0,0,1,0,0,1,0,1,0,0,7,0,0
2027,125,525,168,357,4,353,0,353,154,81,53,31,15,8,1,0,0,0,0,1,0,0,0,0,5,0,4
2028,125,535,203,332,2,330,3,327,91,93,78,38,12,6,0,0,0,0,0,1,0,0,0,0,7,0,1
2029,125,573,229,344,1,343,0,343,121,97,79,19,12,8,0,2,0,1,0,0,0,0,1,0,0,0,3
2030,125,941,412,529,4,525,3,522,152,159,112,40,29,7,0,1,0,0,1,2,0,1,3,0,8,1,6
2031,125,770,336,434,7,427,4,423,133,131,80,42,17,5,0,0,0,0,0,1,0,0,2,0,7,2,3
2032,125,663,199,464,9,455,5,450,184,115,71,45,24,9,0,0,0,0,0,0,0,0,0,0,0,0,2
2033,125,637,201,436,5,431,6,425,167,119,66,24,34,10,0,1,0,0,0,0,0,0,0,1,1,0,2
2034,125,794,258,536,0,536,2,534,169,150,108,61,26,11,0,1,0,0,0,0,0,0,1,1,3,0,3
2035,125,826,308,518,1,517,4,513,185,126,110,45,23,13,0,0,0,0,2,0,0,0,0,1,3,2,3
2036,125,965,344,621,6,615,2,613,156,183,154,59,33,9,1,0,0,0,0,2,0,0,0,3,10,0,3
2037,125,922,380,542,3,539,9,530,113,185,142,31,34,8,2,0,1,0,0,0,0,1,0,3,7,1,2
2038,125,760,308,452,2,450,3,447,125,146,106,29,28,6,1,0,0,0,0,0,0,0,1,1,2,2,0
2039,125,713,320,393,3,390,2,388,120,121,86,17,25,9,4,0,0,0,0,0,0,0,0,0,2,1,3
2040,125,507,243,264,2,262,3,259,72,84,47,21,23,4,0,0,1,0,0,0,0,0,0,2,2,0,3
2041,125,543,283,260,2,258,4,254,56,82,64,22,12,5,0,0,0,0,0,0,0,1,0,1,4,1,6
2042,125,799,304,495,4,491,2,489,147,145,98,47,27,7,0,0,0,0,1,0,1,0,0,0,4,1,11
2043,125,858,250,608,3,605,5,600,202,180,114,60,27,8,1,0,0,0,0,0,0,0,0,2,3,1,2
2044,125,590,230,360,3,357,0,357,99,111,91,16,21,5,0,1,0,0,0,0,0,1,1,1,6,2,2
2045,125,545,197,348,0,348,3,345,86,119,82,26,21,3,0,0,0,0,0,1,0,2,1,1,2,0,1
2046,125,618,297,321,2,319,4,315,73,108,81,21,21,4,1,0,0,0,0,0,1,0,1,0,3,0,1
2047,125,561,240,321,2,319,3,316,84,120,71,21,12,3,0,0,0,0,0,0,0,0,1,0,3,0,1
2048,126,520,235,285,4,281,0,281,72,75,78,29,17,4,0,1,0,0,0,1,0,0,2,0,1,0,1
2049,126,497,221,276,1,275,4,271,57,78,70,27,18,9,1,0,1,0,4,0,0,1,2,0,1,0,2
2050,126,539,198,341,3,338,5,333,60,123,77,28,34,5,0,0,0,0,0,0,2,1,1,0,2,0,0
2051,126,612,210,402,1,401,5,396,79,139,109,27,25,11,1,0,1,0,0,0,1,0,1,0,1,0,1
2052,126,906,356,550,2,548,4,544,156,161,116,57,34,10,2,0,0,1,0,0,0,0,2,1,2,1,1
2053,126,707,274,433,2,431,4,427,102,147,111,34,19,4,0,1,1,0,0,0,1,2,1,0,2,0,2
2054,126,916,381,535,6,529,6,523,165,159,101,34,35,6,0,0,1,0,6,0,0,1,4,2,6,1,2
2055,126,879,346,533,1,532,2,530,132,174,142,38,15,12,0,0,0,0,0,0,0,0,3,1,9,1,3
2056,126,618,275,343,6,337,4,333,89,140,55,28,12,6,0,0,0,0,0,0,0,1,0,1,0,0,1
2057,126,774,339,435,5,430,9,421,125,137,81,34,14,11,1,2,0,1,0,1,1,0,0,1,5,3,4
2058,126,722,295,427,3,424,4,420,124,137,104,28,11,4,1,0,0,0,1,0,4,1,1,0,2,0,2
2059,126,744,179,565,2,563,4,559,80,196,175,42,37,14,1,1,0,0,0,0,0,0,0,0,11,0,2
2060,126,719,146,573,2,571,10,561,72,200,166,66,38,8,0,1,0,0,0,0,0,1,0,0,3,2,4
2061,127,912,388,524,3,521,3,518,113,227,110,29,23,2,0,1,0,0,0,1,0,0,1,2,5,2,2
2062,127,648,311,337,1,336,3,333,64,134,70,38,12,8,1,0,0,0,0,0,0,1,2,1,1,0,1
2063,127,648,303,345,1,344,1,343,54,150,88,15,15,9,0,1,0,0,0,0,1,0,0,1,4,2,3
2064,127,996,492,504,3,501,3,498,135,145,125,49,25,6,3,0,0,0,0,0,0,2,3,0,4,1,0
2065,127,753,324,429,3,426,3,423,136,135,80,37,18,6,0,0,0,0,0,0,1,0,0,1,6,0,3
2066,127,727,321,406,1,405,3,402,137,125,85,20,21,2,0,1,0,1,0,0,0,0,0,0,6,4,0
2067,127,655,293,362,1,361,3,358,115,104,83,27,16,6,0,0,0,1,0,0,1,0,0,1,1,1,2
2068,127,567,276,291,1,290,2,288,77,107,56,31,10,2,0,0,1,0,0,0,0,0,1,0,2,0,1
2069,127,861,342,519,4,515,5,510,162,174,97,24,33,14,0,1,0,0,1,0,1,1,0,0,1,0,1
2070,127,552,240,312,6,306,5,301,80,101,60,27,15,4,1,0,0,0,1,0,0,0,1,0,3,1,7
2071,127,549,237,312,5,307,3,304,90,96,69,22,10,5,6,0,1,0,1,0,0,0,1,0,1,0,2
2072,127,515,209,306,1,305,2,303,104,90,60,29,10,3,1,0,0,0,1,0,0,0,0,1,4,0,0
2073,127,580,254,326,7,319,0,319,93,107,63,28,14,6,2,0,0,0,2,0,0,1,0,0,1,0,2
2074,127,763,355,408,2,406,3,403,126,138,71,30,25,7,0,0,0,0,1,0,1,0,0,1,3,0,0
2075,127,652,276,376,5,371,1,370,135,115,55,26,24,4,1,0,0,1,2,0,1,0,0,0,5,0,1
2076,131,992,450,542,6,536,1,535,49,223,163,31,49,3,0,0,1,0,1,3,0,1,3,1,7,0,0
2077,131,632,276,356,5,351,4,347,44,145,94,16,23,4,0,2,0,2,0,1,0,2,0,1,10,2,1
2078,131,576,195,381,2,379,2,377,25,207,75,20,38,3,0,0,0,0,0,0,0,0,0,0,9,0,0
2079,131,658,227,431,9,422,10,412,37,183,127,21,32,4,0,0,0,1,0,0,0,0,3,1,3,0,0
2080,131,735,320,415,0,415,4,411,40,163,120,31,35,3,1,0,1,0,0,0,0,3,0,1,10,1,2
2081,131,847,310,537,1,536,3,533,56,212,159,15,71,3,3,3,1,0,0,0,1,0,0,0,8,0,1
2082,131,530,212,318,2,316,2,314,41,123,117,13,0,6,1,0,0,1,0,0,0,1,4,0,4,2,1
2083,131,551,175,376,3,373,1,372,45,144,122,11,32,5,1,1,0,0,0,1,0,1,1,3,4,1,0
2084,131,796,255,541,4,537,5,532,72,207,165,32,46,5,0,0,0,0,0,0,0,1,1,1,1,0,1
2085,131,620,228,392,1,391,4,387,42,172,106,26,27,6,0,0,0,0,0,0,0,0,0,2,5,0,1
2086,131,915,358,557,5,552,7,545,53,227,186,31,41,1,0,0,0,0,0,0,0,0,0,1,4,0,1
2087,131,478,189,289,2,287,1,286,30,120,95,13,18,4,0,0,0,0,0,0,0,1,0,0,5,0,0
2088,131,532,205,327,4,323,5,318,35,134,106,11,20,3,1,0,0,0,0,1,0,1,0,0,6,0,0
2089,131,955,391,564,4,560,3,557,84,243,145,32,31,13,0,0,0,1,2,0,0,1,1,0,4,0,0
2090,131,861,377,484,5,479,2,477,77,183,158,23,26,6,1,1,0,0,0,0,0,0,0,0,2,0,0
2091,131,723,281,442,0,442,8,434,57,171,138,24,23,6,1,0,0,0,0,0,0,3,0,1,7,0,3
2092,131,693,275,418,5,413,1,412,68,186,88,23,34,6,1,0,0,0,0,0,0,0,1,1,3,0,1
2093,131,541,178,363,4,359,1,358,48,121,124,19,28,7,0,2,0,1,0,0,0,2,1,1,0,0,4
2094,131,772,264,508,8,500,6,494,83,168,178,19,30,7,0,0,0,0,0,0,1,1,0,2,5,0,0
2095,131,758,295,463,2,461,4,457,98,180,118,18,24,13,0,1,0,1,0,0,0,0,0,0,4,0,0
2096,131,649,240,409,1,408,6,402,61,150,123,26,32,3,0,0,0,0,2,0,0,0,0,0,4,1,0
2097,131,638,263,375,7,368,2,366,75,125,112,29,12,8,0,0,0,0,0,0,0,1,0,0,4,0,0
2098,131,752,294,458,6,452,2,450,72,188,138,16,11,8,0,0,0,0,1,0,1,0,0,3,9,2,1
2099,131,539,267,272,2,270,1,269,33,98,97,15,11,11,0,0,0,2,0,0,0,0,0,0,1,1,0
2100,131,588,258,330,2,328,2,326,35,120,111,21,20,5,1,0,0,0,0,2,0,1,1,1,4,0,4
2101,131,495,178,317,4,313,1,312,42,136,91,16,16,6,0,0,0,0,0,0,0,0,0,0,4,1,0
2102,131,510,148,362,2,360,3,357,39,162,113,19,14,3,0,0,0,0,0,0,0,0,2,1,4,0,0
2103,131,720,241,479,4,475,6,469,68,157,173,22,35,7,0,0,0,0,0,0,0,1,0,0,4,0,2
2104,131,704,198,506,10,496,2,494,77,195,148,24,21,9,0,0,2,1,0,2,0,0,2,0,11,1,1
2105,131,690,280,410,4,406,3,403,78,151,112,27,17,4,0,1,0,0,0,2,0,0,3,3,3,0,2
2106,131,649,238,411,3,408,3,405,85,154,94,29,20,7,1,0,1,2,0,1,0,0,0,1,6,1,3
2107,131,702,239,463,0,463,6,457,83,186,110,33,26,10,1,1,0,0,0,0,0,1,0,0,3,1,2
2108,131,858,332,526,2,524,4,520,94,185,158,31,25,11,2,3,0,0,0,1,1,4,1,0,3,0,1
2109,131,833,323,510,6,504,7,497,98,194,104,49,29,14,0,0,0,0,0,1,0,0,0,2,5,1,0
2110,131,968,331,637,13,624,0,624,93,223,181,47,54,15,0,0,0,1,0,0,0,0,0,0,8,0,2
2111,131,876,295,581,8,573,8,565,86,218,160,40,35,12,0,0,0,1,0,2,0,0,1,2,2,4,2
2112,132,712,323,389,5,384,3,381,73,122,117,37,14,8,0,1,0,0,0,0,0,1,0,3,4,0,1
2113,132,841,322,519,7,512,7,505,86,169,148,40,38,7,1,0,0,0,0,0,0,2,2,1,8,2,1
2114,132,578,258,320,4,316,3,313,63,116,74,26,20,6,1,0,0,0,0,0,0,1,0,0,4,1,1
2115,132,651,306,345,2,343,3,340,66,114,94,21,24,13,1,0,0,0,0,0,0,0,0,1,5,0,1
2116,132,890,396,494,11,483,2,481,77,153,162,37,26,11,0,0,1,3,0,0,1,0,1,1,5,1,2
2117,132,553,256,297,6,291,2,289,60,114,57,24,14,8,0,1,1,0,0,1,0,0,1,2,6,0,0
2118,132,538,232,306,4,302,4,298,56,85,99,31,13,10,0,0,0,0,0,0,0,0,0,1,2,1,0
2119,132,823,411,412,2,410,2,408,87,125,129,26,25,4,0,0,0,0,1,0,0,0,1,0,6,0,4
2120,132,824,382,442,6,436,2,434,104,117,133,35,30,3,1,0,0,1,0,2,0,0,1,1,5,0,1
2121,132,637,280,357,4,353,4,349,69,110,106,24,22,3,1,0,1,0,1,0,1,1,0,0,1,0,9
2122,132,552,256,296,2,294,2,292,65,87,83,23,19,10,0,0,0,0,0,0,0,0,0,0,2,0,3
2123,132,834,392,442,5,437,3,434,91,136,128,33,29,7,0,2,0,0,0,0,0,0,0,1,6,0,1
2124,132,538,254,284,1,283,3,280,53,86,97,15,20,1,0,0,0,0,0,1,0,2,0,0,3,0,2
2125,132,575,268,307,1,306,1,305,56,108,95,11,24,6,0,0,0,0,0,0,0,1,0,0,1,0,3
2126,132,528,214,314,1,313,4,309,62,94,99,21,15,6,0,0,0,0,0,0,0,1,0,1,8,0,2
2127,132,529,202,327,4,323,1,322,55,108,96,27,22,4,0,0,1,1,0,0,0,0,0,1,6,0,1
2128,132,835,368,467,5,462,0,462,97,163,133,34,24,8,1,0,0,0,0,0,0,0,0,0,2,0,0
2129,132,661,239,422,2,420,3,417,109,122,105,40,21,6,1,0,0,0,0,0,0,1,0,1,7,0,4
2130,132,714,277,437,4,433,5,428,94,138,118,36,20,10,0,1,1,0,0,0,0,0,2,0,2,1,5
2131,132,717,306,411,2,409,5,404,65,116,151,30,27,7,0,0,0,0,1,0,0,0,1,0,4,0,2
2132,132,640,263,377,3,374,4,370,111,89,91,35,24,3,1,0,0,2,0,1,0,0,0,4,5,1,3
2133,132,815,303,512,6,506,3,503,121,143,125,36,31,13,0,0,0,1,0,3,1,2,2,1,18,2,4
2134,132,573,227,346,1,345,1,344,62,103,112,28,20,9,0,0,0,0,0,1,0,0,0,0,7,0,2
2135,132,567,228,339,2,337,3,334,77,118,84,16,20,9,0,0,0,2,1,0,0,2,1,1,1,0,2
2136,132,820,368,452,3,449,3,446,103,166,117,22,25,5,2,0,0,0,0,0,0,0,0,0,2,2,2
2137,132,840,372,468,2,466,5,461,85,139,134,37,37,9,1,2,0,2,0,0,2,0,2,0,3,3,5
2138,132,998,411,587,4,583,4,579,136,206,132,47,34,9,2,1,0,0,0,0,0,0,3,0,8,0,1
2139,132,661,286,375,3,372,0,372,62,140,109,34,17,3,0,0,0,1,0,0,0,1,1,0,4,0,0
2140,132,737,342,395,4,391,7,384,64,156,102,24,22,3,3,0,0,0,0,0,0,0,2,1,1,2,4
2141,132,774,308,466,2,464,3,461,95,157,130,36,25,5,0,1,0,0,0,0,0,0,0,0,10,0,2
2142,132,586,253,333,4,329,3,326,60,139,67,21,25,4,0,0,0,0,1,0,0,1,1,2,5,0,0
2143,132,698,342,356,0,356,5,351,74,128,97,21,16,6,0,1,1,0,0,0,1,0,0,0,6,0,0
2144,132,601,283,318,0,318,5,313,60,116,74,27,19,4,0,0,1,2,0,3,1,1,1,2,2,0,0
2145,132,504,244,260,3,257,2,255,54,93,73,21,8,2,0,1,0,0,0,0,0,0,0,3,0,0,0
2146,132,592,285,307,1,306,4,302,61,101,83,24,22,8,0,0,0,0,0,0,0,0,0,0,3,0,0
2147,132,701,335,366,7,359,3,356,68,126,90,28,21,6,0,0,3,4,0,3,1,0,0,0,3,3,0
2148,132,573,211,362,2,360,1,359,67,148,93,19,11,5,0,0,0,0,1,1,0,0,1,1,10,0,2
2149,133,817,208,609,7,602,1,601,88,194,181,50,60,17,0,0,0,0,0,0,1,0,0,0,6,0,4
2150,133,871,201,670,6,664,3,661,95,210,215,50,63,11,0,0,0,0,1,0,1,2,2,0,7,0,4
2151,133,640,152,488,2,486,3,483,141,164,102,31,27,8,0,0,0,0,0,1,0,1,1,0,2,0,5
2152,133,604,164,440,1,439,5,434,139,125,109,24,20,8,0,0,0,1,0,0,0,1,2,0,2,2,1
2153,133,657,184,473,2,471,6,465,117,156,113,34,20,7,0,1,0,0,0,1,0,1,0,1,8,0,6
2154,133,727,220,507,5,502,4,498,143,169,103,42,17,6,0,1,0,2,1,1,1,0,0,0,7,1,4
2155,133,986,455,531,6,525,0,525,112,168,143,33,39,8,1,0,1,1,0,1,0,0,1,1,11,3,2
2156,133,845,349,496,7,489,3,486,107,150,140,21,44,5,0,1,0,0,0,0,0,2,1,5,7,0,3
2157,133,500,187,313,1,312,1,311,94,78,95,20,14,2,1,0,0,0,0,1,0,0,1,1,0,2,2
2158,133,581,246,335,3,332,3,329,91,95,85,24,16,6,1,0,0,0,0,0,0,0,1,4,4,2,0
2159,133,575,237,338,2,336,5,331,73,116,89,17,22,5,1,0,1,0,0,0,0,1,0,0,5,0,1
2160,133,871,377,494,6,488,4,484,125,171,130,25,23,4,0,0,0,0,2,0,0,1,1,0,1,0,1
2161,133,588,228,360,7,353,2,351,105,114,73,30,17,4,0,0,0,0,0,0,0,0,1,0,4,0,3
2162,133,839,255,584,2,582,5,577,219,145,117,39,31,10,0,1,0,0,2,2,0,0,0,2,4,1,4
2163,133,531,239,292,0,292,6,286,55,109,81,9,18,3,0,0,0,1,0,0,0,2,0,2,5,0,1
2164,133,586,276,310,3,307,2,305,50,104,104,23,13,3,1,2,0,0,0,1,0,0,1,0,2,1,0
2165,133,809,294,515,12,503,0,503,88,180,153,32,26,8,1,0,2,0,0,2,0,0,3,0,5,1,2
2166,133,821,263,558,10,548,5,543,96,171,183,37,31,13,0,0,0,0,0,0,0,1,2,0,8,0,1
2167,133,822,261,561,6,555,6,549,106,167,185,33,31,8,2,1,0,1,0,1,1,1,1,1,9,0,1
2168,133,855,289,566,11,555,2,553,46,166,245,37,43,11,0,0,0,1,0,0,0,1,1,0,1,0,1
2169,133,786,234,552,5,547,6,541,49,170,222,39,50,2,0,0,0,1,2,0,0,0,2,0,2,0,2
2170,133,633,236,397,1,396,5,391,54,132,114,42,26,9,1,0,0,0,0,1,0,0,0,1,4,0,7
2171,133,648,215,433,3,430,5,425,75,119,156,33,25,6,0,0,0,0,0,0,0,1,0,1,5,2,2
2172,133,640,216,424,7,417,4,413,80,130,127,38,24,4,0,0,0,0,0,0,0,1,0,2,4,1,2
2173,133,612,97,515,3,512,2,510,65,168,171,33,64,7,0,0,0,0,0,0,0,0,0,0,2,0,0
2174,133,593,107,486,7,479,3,476,57,142,175,33,54,4,1,0,0,0,0,0,0,0,0,0,7,0,3
2175,133,605,115,490,0,490,4,486,69,147,154,44,55,10,0,0,0,0,0,0,0,0,0,1,4,1,1
2176,133,560,110,450,3,447,6,441,43,155,144,44,42,7,0,0,0,0,0,0,0,2,0,0,4,0,0
2177,133,998,276,722,7,715,1,714,69,245,216,70,82,12,0,0,0,0,0,0,0,2,0,0,8,3,7
2178,133,805,314,491,5,486,4,482,87,196,140,23,21,5,1,0,1,0,1,1,0,0,1,0,3,0,2
2179,133,916,351,565,5,560,7,553,99,211,165,28,31,7,0,0,0,0,0,0,0,0,1,1,6,4,0
2180,133,821,148,673,6,667,8,659,72,235,209,67,54,11,0,1,0,0,0,0,0,0,0,0,4,0,6
2181,133,761,144,617,1,616,11,605,85,213,177,48,59,12,0,0,0,0,0,0,0,0,0,0,5,4,2
2182,133,665,124,541,4,537,7,530,73,173,148,47,61,11,0,0,0,1,1,0,1,2,3,0,8,0,1
2183,133,679,115,564,4,560,11,549,64,198,185,32,49,9,1,0,0,2,1,0,0,1,0,0,4,1,2
2184,133,644,144,500,11,489,2,487,66,177,149,34,43,11,1,0,0,0,0,0,0,0,1,0,5,0,0
2185,133,570,124,446,8,438,2,436,56,152,140,39,36,6,0,0,0,1,0,0,0,0,0,0,2,1,3
2186,133,957,443,514,7,507,3,504,73,168,161,44,34,6,0,0,0,0,0,2,1,0,2,0,9,1,3
2187,133,963,427,536,4,532,5,527,57,173,173,45,41,12,1,0,0,0,1,0,0,3,0,0,9,3,9
2188,133,965,265,700,8,692,3,689,81,228,226,57,68,14,1,0,0,0,2,0,0,0,0,0,9,1,2
2189,134,714,215,499,6,493,7,486,73,166,146,40,48,5,0,0,0,1,0,1,1,0,1,0,3,1,0
2190,134,666,198,468,6,462,3,459,55,160,144,40,34,12,0,0,0,0,0,1,0,1,1,1,7,0,3
2191,134,843,251,592,4,588,6,582,86,228,149,59,39,5,0,1,0,0,0,1,0,2,2,1,7,0,2
2192,134,899,263,636,3,633,7,626,98,244,169,42,43,16,0,0,0,0,0,0,0,5,0,0,6,0,3
2193,134,605,228,377,6,371,2,369,54,143,127,15,21,4,0,0,0,0,0,0,0,1,1,0,0,0,3
2194,134,683,251,432,5,427,3,424,65,145,147,23,26,6,1,0,1,0,0,0,0,0,1,0,8,0,1
2195,134,529,161,368,0,368,2,366,52,140,117,19,27,4,0,0,0,1,0,0,0,1,0,0,5,0,0
2196,134,550,195,355,2,353,3,350,41,149,118,15,20,3,0,0,0,0,0,0,0,0,0,0,2,0,2
2197,134,521,213,308,2,306,3,303,65,107,85,18,17,2,2,0,0,0,0,2,0,1,0,2,2,0,0
2198,134,597,217,380,5,375,5,370,50,139,103,28,23,10,1,3,0,0,0,0,0,3,0,0,8,1,1
2199,134,612,191,421,2,419,1,418,59,151,124,21,41,8,0,1,0,0,0,0,0,1,2,0,5,2,3
2200,134,637,191,446,1,445,6,439,52,165,141,26,47,2,0,0,0,0,0,0,0,1,0,1,0,2,2
2201,134,640,236,404,0,404,3,401,61,153,118,32,21,5,1,0,0,0,1,1,0,0,0,1,5,2,0
2202,134,682,276,406,0,406,4,402,61,161,126,23,23,0,1,0,0,0,0,0,0,0,0,0,4,2,1
2203,134,945,317,628,8,620,0,620,143,243,156,30,33,8,0,0,0,2,0,0,0,1,0,0,4,0,0
2204,134,527,176,351,1,350,3,347,45,120,137,14,21,5,0,0,0,0,0,0,0,0,1,0,3,1,0
2205,134,511,185,326,2,324,1,323,48,138,81,19,23,3,0,0,0,0,3,2,0,0,1,0,4,0,1
2206,134,624,191,433,2,431,3,428,52,167,139,28,26,5,1,0,0,0,0,1,1,1,1,0,4,0,2
2207,134,633,259,374,2,372,4,368,59,146,111,23,17,1,0,0,0,0,1,1,0,1,0,0,6,1,1
2208,134,505,156,349,3,346,1,345,42,121,127,23,20,2,3,0,0,0,0,1,0,2,0,1,3,0,0
2209,134,546,182,364,2,362,0,362,59,129,113,21,19,5,4,0,0,0,0,1,1,0,3,1,5,0,1
2210,134,523,170,353,2,351,0,351,66,127,106,20,19,2,0,0,0,0,0,0,0,1,0,1,5,2,2
2211,134,509,178,331,0,331,0,331,67,121,91,19,15,1,2,0,0,0,0,0,0,2,1,2,5,0,5
2212,134,860,348,512,3,509,1,508,75,213,151,21,31,5,2,0,0,0,0,0,0,0,2,1,4,2,1
2213,134,549,211,338,4,334,2,332,44,141,91,15,18,7,0,4,0,0,0,1,5,0,2,1,1,0,2
2214,134,879,217,662,2,660,8,652,150,181,140,106,34,23,1,0,0,0,0,0,0,0,0,1,9,1,6
2215,134,764,213,551,4,547,3,544,111,157,121,86,32,20,2,0,0,0,0,2,0,0,0,2,11,0,0
2216,134,586,158,428,2,426,7,419,92,119,115,37,33,9,0,1,0,0,0,0,2,0,0,0,7,1,3
2217,134,533,156,377,3,374,0,374,68,121,104,38,31,4,1,0,0,0,0,0,0,1,0,0,5,0,1
2218,134,666,229,437,4,433,3,430,55,179,132,23,25,4,0,1,0,0,2,3,0,0,2,0,1,0,3
2219,134,581,203,378,8,370,3,367,36,118,147,20,23,13,0,0,0,0,0,0,1,0,0,1,7,0,1
2220,134,927,395,532,13,519,4,515,34,174,223,34,40,2,0,0,0,1,2,0,0,0,1,2,2,0,0
2221,134,801,289,512,7,505,1,504,54,198,172,34,28,4,0,1,0,0,1,0,0,1,1,0,8,0,2
2222,134,841,263,578,3,575,11,564,66,251,161,22,40,10,0,0,1,0,1,0,1,0,0,1,9,0,1
2223,134,708,254,454,3,451,6,445,64,159,160,34,21,4,0,1,0,0,0,0,0,0,2,0,0,0,0
2224,134,904,329,575,11,564,2,562,55,228,172,37,43,5,0,0,0,2,2,3,0,0,3,0,9,1,2
2225,134,681,207,474,1,473,5,468,117,164,92,47,29,10,0,0,0,0,0,1,0,0,2,0,2,2,2
2226,134,749,206,543,1,542,3,539,133,177,125,55,27,6,3,0,1,0,1,0,0,1,1,1,3,1,4
2227,134,738,305,433,2,431,2,429,49,133,193,21,18,5,0,0,0,0,0,0,0,1,1,1,6,1,0
2228,134,781,293,488,4,484,0,484,120,156,123,39,26,4,0,0,0,1,0,0,0,0,0,2,6,2,5
2229,134,631,210,421,4,417,0,417,87,134,130,31,19,9,0,0,0,0,0,0,0,0,0,0,5,2,0
2230,134,586,190,396,2,394,2,392,71,128,127,27,27,1,1,0,0,0,0,2,0,0,0,0,4,3,1
2231,134,691,172,519,6,513,3,510,93,166,147,61,18,13,0,0,0,2,0,0,1,0,0,0,3,2,4
2232,134,717,133,584,12,572,2,570,114,179,154,60,38,13,1,0,0,2,0,0,0,0,1,0,5,2,1
2233,134,800,245,555,9,546,1,545,69,198,169,52,29,15,1,0,0,4,0,0,0,0,1,1,5,1,0
2234,134,749,296,453,3,450,6,444,84,130,161,28,25,5,1,0,0,0,0,0,1,0,0,1,8,0,0
2235,134,535,190,345,4,341,2,339,51,82,103,72,14,8,1,0,0,0,0,0,0,1,2,0,5,0,0
2236,134,578,175,403,2,401,9,392,60,95,112,93,12,7,2,0,0,0,0,0,1,0,1,0,5,0,4
2237,135,542,194,348,1,347,4,343,76,123,88,27,14,7,0,0,0,0,2,0,0,0,0,0,4,1,1
2238,135,536,208,328,2,326,2,324,46,112,111,23,15,5,2,0,0,0,0,1,0,1,0,1,5,1,1
2239,135,599,145,454,6,448,0,448,149,135,97,31,25,3,0,0,0,0,0,0,0,1,0,0,5,0,2
2240,135,499,207,292,3,289,2,287,64,88,84,24,17,5,0,0,0,0,0,0,0,0,0,0,3,1,1
2241,135,537,209,328,4,324,4,320,87,96,85,14,23,4,0,0,0,0,0,1,1,0,0,1,4,0,4
2242,135,666,267,399,2,397,3,394,70,117,127,32,24,9,0,2,1,0,1,3,1,2,0,1,1,2,1
2243,135,775,266,509,6,503,7,496,111,158,134,40,27,5,1,0,0,2,0,0,0,0,1,2,11,1,3
2244,135,905,332,573,3,570,6,564,117,191,161,46,27,10,2,0,0,0,1,1,0,0,0,0,4,1,3
2245,135,847,308,539,11,528,5,523,85,192,159,28,30,12,1,0,1,0,2,0,0,2,1,1,7,0,2
2246,135,558,223,335,4,331,3,328,70,105,103,18,21,4,0,0,0,1,0,0,0,0,0,0,4,0,2
2247,135,549,234,315,1,314,2,312,41,115,104,14,15,4,0,0,0,0,0,1,0,3,1,1,8,1,4
2248,135,518,217,301,1,300,2,298,49,79,118,21,22,1,0,0,0,0,0,0,1,0,1,0,4,1,1
2249,135,510,221,289,1,288,5,283,46,84,118,14,9,7,0,0,0,1,1,0,0,1,1,0,1,0,0
2250,135,923,351,572,2,570,9,561,114,193,164,38,34,7,1,0,0,0,0,1,1,2,1,1,4,0,0
2251,135,739,259,480,5,475,6,469,80,161,135,33,39,13,0,0,0,0,0,0,0,0,0,2,4,1,1
2252,135,716,244,472,5,467,7,460,74,170,138,31,33,4,1,1,0,0,0,1,0,0,0,1,5,1,0
2253,135,639,179,460,0,460,6,454,100,170,111,31,25,7,1,0,0,0,1,1,0,0,0,1,5,1,0
2254,135,875,277,598,3,595,4,591,156,157,173,42,42,6,2,0,1,0,0,0,0,1,0,2,7,0,2
2255,135,724,240,484,2,482,4,478,100,140,132,52,21,12,0,0,0,0,2,0,0,1,1,2,10,1,4
2256,135,765,268,497,2,495,5,490,90,163,149,34,26,19,0,0,0,0,1,0,0,0,2,0,3,0,3
2257,135,763,261,502,3,499,4,495,93,157,186,22,21,7,0,0,0,1,0,0,0,1,1,0,3,1,2
2258,135,718,233,485,0,485,5,480,65,153,192,24,34,6,1,0,0,0,0,0,0,0,1,0,3,0,1
2259,135,955,294,661,13,648,6,642,229,221,101,37,27,11,0,1,0,0,0,2,0,1,0,2,2,2,6
2260,135,628,231,397,2,395,3,392,56,123,151,22,26,5,0,0,0,0,0,1,0,1,0,2,5,0,0
2261,135,755,217,538,8,530,7,523,122,201,125,30,21,9,0,0,0,1,3,0,1,0,2,1,4,1,2
2262,135,691,233,458,4,454,5,449,124,155,106,32,16,2,0,0,0,0,0,1,0,0,0,2,8,0,3
2263,135,520,175,345,3,342,4,338,67,110,107,25,22,0,0,0,0,0,0,0,2,0,1,0,4,0,0
2264,135,557,195,362,4,358,1,357,62,113,130,19,24,5,0,0,0,0,0,0,0,0,0,0,4,0,0
2265,135,621,233,388,0,388,3,385,52,137,124,28,32,3,0,0,0,1,0,0,0,1,1,0,5,1,0
2266,135,625,215,410,2,408,1,407,44,132,145,37,22,8,0,0,0,0,0,0,0,7,0,2,8,2,0
2267,135,984,533,451,8,443,1,442,48,133,177,28,32,8,1,0,0,0,0,0,0,0,2,1,10,1,1
2268,136,610,248,362,3,359,0,359,91,104,98,30,25,7,0,0,1,0,0,0,0,0,0,0,1,0,2
2269,136,695,307,388,6,382,3,379,94,98,113,32,24,6,0,3,0,0,0,0,0,0,0,1,6,0,2
2270,136,776,304,472,1,471,1,470,126,156,128,30,17,3,0,0,0,1,0,1,0,1,2,0,3,2,0
2271,136,726,305,421,5,416,2,414,94,108,128,40,23,9,2,0,0,0,0,1,1,0,0,1,4,1,2
2272,136,899,376,523,3,520,4,516,127,151,147,39,25,8,0,0,1,0,0,3,0,1,0,1,11,1,1
2273,136,689,252,437,3,434,5,429,118,143,96,37,15,7,0,0,0,0,0,0,0,1,1,1,4,1,5
2274,136,701,267,434,4,430,2,428,121,123,97,37,25,12,2,0,0,0,0,0,1,0,0,2,4,0,4
2275,136,715,299,416,5,411,4,407,113,146,89,19,23,3,1,0,0,0,1,0,2,2,1,1,3,1,2
2276,136,699,305,394,1,393,0,393,119,136,103,9,9,9,1,0,0,0,0,0,2,0,0,0,4,0,1
2277,136,926,344,582,4,578,5,573,143,180,160,41,21,9,1,0,0,1,0,0,0,0,2,1,6,1,7
2278,136,863,355,508,4,504,6,498,100,158,181,33,12,8,0,0,1,0,0,0,0,0,1,0,3,0,1
2279,136,720,310,410,5,405,1,404,88,136,127,19,16,4,0,0,0,3,2,0,2,1,0,0,3,1,2
2280,136,755,300,455,2,453,5,448,83,164,133,37,16,2,2,1,0,2,1,1,0,1,0,3,0,0,2
2281,136,521,182,339,5,334,6,328,49,133,109,14,15,4,2,0,0,0,0,0,1,0,0,0,0,0,1
2282,136,501,206,295,3,292,4,288,54,97,97,11,12,5,1,0,0,0,0,1,0,0,0,0,3,0,7
2283,136,570,183,387,3,384,2,382,50,117,162,27,20,3,0,0,0,0,0,0,0,0,0,0,1,1,1
2284,136,814,283,531,3,528,0,528,95,171,155,40,43,7,0,0,0,0,1,0,2,0,1,0,12,0,1
2285,136,1014,341,673,6,667,3,664,90,307,203,29,18,3,0,0,0,0,4,1,0,1,0,0,4,0,4
2286,136,1002,293,709,10,699,6,693,252,174,123,73,43,12,0,0,0,0,0,0,0,3,1,0,5,1,6
2287,136,487,137,350,5,345,5,340,118,97,58,30,22,4,0,0,1,0,0,0,0,1,0,0,5,0,4
2288,136,533,140,393,0,393,1,392,107,140,64,44,20,3,1,2,1,0,0,0,1,0,0,0,4,0,5
2289,136,627,203,424,3,421,2,419,100,129,108,41,19,13,2,0,0,0,0,0,0,0,2,0,3,0,2
2290,136,612,187,425,3,422,3,419,94,118,119,38,28,9,0,0,0,1,0,0,0,2,2,0,7,1,0
2291,136,1004,398,606,6,600,2,598,170,173,135,58,23,10,1,0,0,0,0,1,0,4,4,2,11,0,6
2292,136,825,310,515,5,510,3,507,112,151,141,34,41,9,1,1,0,1,1,1,0,5,0,1,6,0,2
2293,136,750,297,453,8,445,2,443,98,146,108,25,29,8,1,0,0,1,0,2,0,6,4,0,8,2,5
2294,136,591,245,346,3,343,5,338,76,103,92,29,21,4,0,0,0,0,1,0,1,1,0,0,8,1,1
2295,136,567,254,313,5,308,2,306,58,108,77,28,21,4,0,0,1,2,0,1,0,2,1,0,3,0,0
2296,136,751,325,426,6,420,4,416,106,130,118,26,17,9,0,0,0,1,0,0,0,0,0,0,6,2,1
2297,136,615,263,352,2,350,4,346,61,117,100,37,13,8,0,0,0,0,0,0,0,1,0,1,5,2,1
2298,136,678,266,412,4,408,4,404,83,104,135,27,29,5,1,0,1,2,1,1,0,0,1,1,10,1,2
2299,136,705,322,383,1,382,0,382,67,112,132,28,21,2,0,0,0,1,0,0,0,1,0,0,15,2,1
2300,136,824,233,591,6,585,7,578,166,163,132,50,35,9,3,1,1,1,0,0,0,1,1,2,9,0,4
2301,136,734,229,505,6,499,2,497,155,152,105,47,18,5,0,1,0,1,0,0,1,0,2,0,5,1,4
2302,136,893,367,526,7,519,6,513,125,176,127,30,32,12,0,0,1,0,1,2,0,0,3,0,3,0,1
2303,136,928,405,523,9,514,3,511,125,160,114,56,33,6,0,1,0,0,0,2,0,0,1,0,7,1,5
2304,136,1006,513,493,8,485,5,480,100,140,150,41,38,3,0,0,0,0,0,1,1,2,0,0,3,0,1
2305,136,720,241,479,6,473,6,467,80,154,141,44,31,10,1,0,0,0,0,0,0,1,1,0,0,0,4
2306,136,807,321,486,1,485,8,477,101,128,170,33,26,8,0,0,0,0,0,1,0,0,0,1,6,1,2
2307,136,969,432,537,4,533,3,530,146,146,140,35,37,8,0,1,0,2,0,0,0,1,0,1,8,2,3
2308,136,856,323,533,2,531,2,529,106,167,171,33,25,9,2,1,0,1,5,0,1,0,0,1,6,0,1
2309,136,670,222,448,2,446,4,442,159,130,80,30,19,16,0,0,0,0,2,1,0,0,0,0,2,1,2
2310,136,714,229,485,5,480,7,473,148,137,100,41,26,10,0,1,1,1,0,0,1,1,0,0,5,1,0
2311,136,784,217,567,3,564,8,556,203,176,109,37,20,3,0,0,0,0,2,0,0,0,2,0,2,2,0
2312,141,499,171,328,2,326,3,323,106,95,58,34,17,5,2,2,0,0,0,0,0,0,1,0,2,0,1
2313,141,508,155,353,1,352,2,350,89,97,81,42,21,5,0,1,0,1,0,0,0,2,0,0,9,0,2
2314,141,522,174,348,4,344,3,341,63,120,83,42,18,6,1,0,0,0,0,0,0,0,0,0,5,0,3
2315,141,548,188,360,5,355,4,351,95,107,96,24,13,6,0,0,0,0,0,0,0,1,0,0,4,1,4
2316,141,1012,312,700,7,693,4,689,181,221,146,67,35,17,0,1,2,0,0,1,0,1,2,2,7,2,4
2317,141,581,126,455,2,453,6,447,138,138,83,47,28,5,0,1,1,0,0,0,0,0,0,2,2,0,2
2318,141,565,170,395,3,392,7,385,91,117,85,43,30,6,1,0,0,0,1,0,0,1,0,0,4,1,5
2319,141,1010,278,732,3,729,6,723,175,203,180,70,46,21,0,1,0,0,0,1,2,0,0,0,10,0,14
2320,141,983,223,760,6,754,8,746,172,235,163,98,37,21,0,0,0,0,0,0,0,1,1,1,5,1,11
2321,141,915,292,623,5,618,6,612,126,190,148,109,20,10,0,0,0,1,0,0,0,1,0,1,3,0,3
2322,142,515,143,372,0,372,4,368,95,113,73,45,23,6,0,0,0,0,0,0,0,0,0,0,1,3,9
2323,142,557,129,428,5,423,11,412,91,113,81,65,25,18,0,0,0,0,0,0,0,0,6,0,6,0,7
2324,142,524,178,346,5,341,2,339,87,94,69,56,18,9,0,0,0,0,0,0,0,0,0,0,4,0,2
2325,142,510,165,345,5,340,2,338,75,91,87,46,18,14,0,1,0,0,0,0,0,1,0,1,3,0,1
2326,142,733,115,618,5,613,10,603,142,171,134,88,32,19,0,0,0,2,0,0,3,0,0,1,3,0,8
2327,142,756,128,628,4,624,6,618,160,174,142,81,35,20,0,0,0,1,0,0,0,0,0,1,1,1,2
2328,142,503,171,332,1,331,2,329,117,71,76,45,6,9,0,0,0,0,0,0,0,0,0,0,2,0,3
2329,142,541,163,378,2,376,6,370,154,81,50,44,12,12,1,1,0,0,0,0,0,2,0,0,4,2,7
2330,143,562,111,451,5,446,7,439,127,147,70,56,17,11,0,0,0,0,0,0,1,0,0,0,4,0,6
2331,143,570,114,456,1,455,10,445,137,143,77,41,24,11,0,0,0,0,1,1,0,2,1,0,4,0,3
2332,143,579,169,410,4,406,6,400,140,138,71,34,9,2,0,0,0,0,0,0,0,0,0,0,5,0,1
2333,143,615,163,452,4,448,3,445,143,138,79,42,28,7,0,0,0,0,0,0,0,0,0,1,5,1,1
2334,143,904,203,701,7,694,13,681,286,161,112,63,29,12,3,0,0,0,0,0,1,1,2,0,4,0,7
2335,143,581,119,462,2,460,4,456,220,93,74,37,12,7,0,0,0,0,0,0,0,0,1,0,1,0,11
2336,143,763,165,598,4,594,2,592,243,148,101,56,20,6,1,0,0,1,0,1,0,0,1,0,4,0,10
2337,143,631,144,487,6,481,9,472,170,143,76,40,25,9,1,0,0,0,0,0,0,0,0,0,5,0,3
2338,143,649,139,510,3,507,4,503,215,118,75,59,14,5,0,0,0,0,1,1,0,0,0,0,5,0,10
2339,143,951,230,721,7,714,5,709,283,183,117,68,32,10,1,0,0,0,0,0,0,0,0,1,4,0,10
2340,143,540,112,428,4,424,7,417,157,107,76,29,28,4,0,0,0,1,0,0,0,0,0,3,4,0,8
2341,143,798,188,610,2,608,5,603,248,165,82,71,11,10,0,0,0,0,0,1,0,0,0,0,6,0,9
2342,143,822,179,643,2,641,9,632,289,158,90,49,19,15,0,0,0,0,0,1,0,0,0,0,2,1,8
2343,143,718,184,534,2,532,2,530,278,135,39,48,8,7,2,0,0,0,1,1,0,0,0,2,2,1,6
2344,143,519,119,400,1,399,1,398,187,87,56,41,11,5,0,0,0,0,0,1,0,0,0,0,4,0,6
2345,143,782,184,598,5,593,7,586,320,110,68,51,6,9,0,1,0,0,0,0,0,2,1,0,6,0,12
2346,143,887,272,615,7,608,6,602,239,170,89,52,23,13,1,0,0,1,0,0,0,0,1,2,7,0,4
2347,143,688,244,444,1,443,4,439,145,111,100,39,31,4,0,0,0,0,0,0,0,0,0,1,5,0,3
2348,143,877,258,619,3,616,4,612,208,181,102,64,31,9,0,0,0,0,0,0,1,0,0,0,11,1,4
2349,143,764,281,483,4,479,1,478,115,150,134,36,26,10,3,0,0,0,0,0,0,0,2,0,2,0,0
2350,143,749,238,511,1,510,3,507,156,150,108,45,23,12,0,0,0,0,0,2,0,0,1,0,4,1,5
2351,143,548,94,454,4,450,5,445,139,129,76,71,17,8,0,0,0,0,0,0,0,0,0,0,5,0,0
2352,143,561,106,455,4,451,5,446,121,115,84,92,19,7,0,1,0,0,0,0,0,0,1,0,4,0,2
2353,143,637,119,518,2,516,5,511,179,149,77,57,15,13,0,2,0,0,0,0,1,0,0,1,7,0,10
2354,143,719,126,593,3,590,7,583,196,168,95,78,27,8,0,1,0,0,0,0,0,0,0,1,2,1,6
2355,143,651,133,518,4,514,1,513,179,149,85,59,15,14,0,1,0,0,1,0,1,0,0,0,4,0,5
2356,143,964,198,766,12,754,7,747,260,201,118,111,29,17,0,0,0,0,0,0,0,0,1,1,3,0,6
2357,143,999,214,785,5,780,25,755,242,203,148,95,26,12,0,1,0,1,0,2,0,1,1,1,8,0,14
2358,143,830,275,555,6,549,6,543,85,182,146,77,32,8,0,0,0,1,0,0,0,1,1,2,6,0,2
2359,143,894,300,594,5,589,4,585,122,156,161,58,55,5,0,0,0,0,0,0,0,0,2,1,17,4,4
2360,143,522,84,438,2,436,7,429,131,107,84,72,22,4,0,0,0,0,0,0,0,1,1,1,2,0,4
2361,143,557,111,446,4,442,4,438,142,128,59,76,15,7,1,0,0,0,0,0,0,0,0,0,1,0,9
2362,144,710,159,551,3,548,3,545,219,145,61,73,21,14,0,0,0,0,0,0,0,0,0,1,4,0,7
2363,144,766,170,596,2,594,4,590,221,165,78,74,16,17,0,1,1,0,0,0,0,0,0,1,2,0,14
2364,144,761,177,584,9,575,0,575,270,144,62,41,24,15,1,0,0,1,0,1,0,0,0,0,1,0,15
2365,144,883,232,651,4,647,8,639,275,172,74,59,32,16,0,0,0,0,0,0,0,0,1,1,0,0,9
2366,144,605,184,421,3,418,4,414,128,105,90,51,17,10,1,0,0,0,0,0,0,0,1,2,3,0,6
2367,144,761,225,536,5,531,3,528,225,134,72,59,17,7,0,0,0,0,0,0,1,1,0,0,5,0,7
2368,144,557,183,374,4,370,3,367,105,105,96,32,12,6,0,0,0,0,0,0,0,0,1,0,8,0,2
2369,144,786,250,536,4,532,4,528,163,186,92,50,15,15,0,0,0,3,0,0,0,0,0,0,2,0,2
2370,144,764,283,481,4,477,7,470,163,132,92,43,15,9,0,1,0,2,0,0,0,0,0,0,7,0,6
2371,144,602,212,390,4,386,3,383,112,111,89,29,20,9,1,0,0,1,0,1,0,1,0,0,9,0,0
2372,144,885,277,608,5,603,4,599,164,206,134,45,35,8,0,0,0,0,0,0,0,2,0,0,3,1,1
2373,144,752,202,550,3,547,6,541,196,133,107,60,22,13,1,1,0,0,0,0,0,0,0,0,2,0,6
2374,144,790,212,578,3,575,4,571,191,134,111,62,31,25,0,0,0,1,0,1,0,0,0,1,4,0,10
2375,144,822,154,668,4,664,7,657,272,163,81,80,21,15,0,1,1,0,0,0,1,0,0,1,6,0,15
2376,144,1005,207,798,8,790,6,784,403,144,92,81,29,18,0,0,0,2,0,2,0,0,0,0,4,0,9
2377,144,478,235,243,2,241,2,239,41,97,63,19,10,4,0,0,0,0,0,1,0,0,0,0,3,0,1
2378,144,532,284,248,0,248,4,244,41,102,70,10,11,3,0,0,1,0,0,0,0,0,1,3,2,0,0
2379,144,669,290,379,4,375,1,374,85,105,105,39,19,6,0,2,1,1,0,0,0,2,2,1,3,0,3
2380,144,658,267,391,7,384,0,384,74,118,120,30,22,7,2,0,1,0,1,0,0,1,1,2,5,0,0
2381,144,929,221,708,4,704,8,696,226,197,107,88,39,12,1,1,0,0,0,0,0,0,0,0,5,2,18
2382,145,697,168,529,3,526,4,522,218,111,98,39,24,8,0,0,0,1,0,0,0,1,1,0,10,0,11
2383,145,769,210,559,1,558,2,556,220,119,119,43,20,20,0,0,0,1,0,0,1,0,0,0,6,0,7
2384,145,755,233,522,1,521,6,515,192,144,109,31,21,8,0,0,0,0,0,0,0,1,0,1,2,2,4
2385,145,842,313,529,9,520,4,516,144,168,117,46,26,4,0,0,0,0,0,3,0,0,0,0,3,0,5
2386,145,834,337,497,6,491,3,488,146,152,115,43,11,7,2,0,2,1,0,0,0,0,0,0,3,3,3
2387,145,846,308,538,2,536,6,530,193,163,91,42,16,7,1,3,0,0,0,1,1,2,0,1,5,0,4
2388,145,846,296,550,3,547,6,541,180,168,114,37,20,3,0,0,0,0,0,1,0,1,0,2,9,0,6
2389,145,814,291,523,3,520,4,516,123,180,117,42,27,12,2,1,0,0,0,0,0,0,0,0,5,1,6
2390,145,770,276,494,5,489,1,488,118,174,107,43,24,7,0,1,0,0,0,0,1,0,0,0,11,2,0
2391,145,742,279,463,5,458,3,455,138,139,98,34,24,13,0,0,0,0,1,0,0,0,0,0,4,0,4
2392,145,606,232,374,2,372,6,366,86,105,113,22,13,15,1,1,0,0,0,0,0,0,0,0,8,0,2
2393,145,856,322,534,4,530,4,526,127,174,118,46,34,9,2,0,0,0,1,0,0,1,0,0,11,1,2
2394,145,722,235,487,4,483,0,483,142,159,83,44,24,9,0,1,1,0,0,0,0,0,1,1,6,4,8
2395,145,603,205,398,3,395,2,393,89,142,79,39,20,8,0,0,0,1,0,0,0,0,1,1,8,2,3
2396,145,759,219,540,6,534,3,531,122,171,116,53,36,10,0,1,0,0,0,0,0,2,2,2,2,2,12
2397,145,699,238,461,6,455,5,450,121,176,81,35,20,4,2,0,0,2,1,0,1,2,0,0,2,1,2
2398,145,559,187,372,4,368,4,364,82,138,81,33,18,10,0,0,0,0,0,0,0,0,0,0,2,0,0
2399,145,484,192,292,0,292,0,292,61,104,66,31,26,1,0,0,0,0,0,0,0,0,0,0,3,0,0
2400,146,625,173,452,5,447,7,440,198,88,76,40,16,13,0,0,0,0,0,2,0,1,0,1,1,0,4
2401,146,538,140,398,5,393,7,386,133,95,75,48,16,8,0,1,0,0,0,0,0,1,1,0,6,0,2
2402,146,589,134,455,5,450,10,440,147,123,80,47,20,8,1,1,0,0,1,1,0,3,0,0,7,0,1
2403,146,828,242,586,4,582,7,575,134,216,120,52,23,13,0,0,0,0,2,1,0,1,1,1,8,1,2
2404,146,781,184,597,4,593,6,587,227,186,92,44,23,8,0,0,0,0,0,1,0,0,0,0,1,0,5
2405,146,912,264,648,4,644,6,638,217,179,136,48,34,13,1,0,0,1,0,0,0,0,0,1,5,0,3
2406,146,743,191,552,5,547,6,541,178,149,103,63,29,8,0,0,0,0,0,0,0,0,1,0,7,0,3
2407,146,528,186,342,2,340,2,338,85,103,101,24,13,7,0,0,0,0,0,0,0,1,0,0,2,0,2
2408,146,765,304,461,5,456,0,456,114,138,129,26,31,6,0,0,0,0,0,2,0,0,1,1,6,0,2
2409,146,531,200,331,2,329,4,325,91,120,70,16,12,6,1,0,0,0,0,0,0,2,0,0,7,0,0
2410,146,569,180,389,1,388,7,381,145,104,70,30,12,6,0,0,0,0,1,0,0,0,0,0,8,1,4
2411,146,718,231,487,4,483,7,476,137,156,109,37,20,5,0,0,1,0,0,1,0,1,0,1,1,1,6
2412,146,767,235,532,0,532,7,525,176,145,106,49,24,9,0,1,0,0,0,0,0,0,1,1,8,0,5
2413,146,756,221,535,2,533,4,529,224,157,90,32,16,3,0,0,0,0,0,0,0,0,3,0,4,0,0
2414,146,840,233,607,0,607,0,607,168,193,138,62,23,6,1,0,0,0,0,1,0,1,0,1,7,0,6
2415,146,547,142,405,0,405,11,394,151,99,85,31,16,3,0,0,0,1,1,0,0,0,0,0,0,0,7
2416,146,688,231,457,3,454,2,452,155,136,91,28,24,6,0,0,0,0,0,1,0,1,3,0,4,0,3
2417,146,710,198,512,3,509,4,505,196,158,62,49,22,2,1,0,0,1,0,0,0,3,2,0,3,0,6
2418,146,636,171,465,7,458,5,453,141,149,89,35,23,3,0,2,0,0,1,1,0,0,0,1,2,0,6
2419,146,512,141,371,4,367,4,363,124,110,66,25,22,6,0,0,0,0,0,0,0,0,0,0,2,0,8
2420,151,811,257,554,12,542,4,538,216,136,88,68,14,8,0,0,0,0,1,0,0,0,0,0,1,0,6
2421,151,705,231,474,4,470,6,464,183,122,71,49,14,8,1,0,1,0,0,0,0,1,1,1,2,2,8
2422,151,827,265,562,5,557,3,554,193,159,102,54,18,9,0,0,0,1,0,3,1,0,0,1,0,6,7
2423,151,676,193,483,5,478,0,478,151,138,88,38,32,13,2,1,1,2,0,0,0,1,0,2,7,2,0
2424,151,998,339,659,3,656,8,648,192,201,144,41,32,7,1,0,0,0,0,2,0,4,1,0,12,1,10
2425,151,765,214,551,8,543,5,538,167,182,86,48,30,7,0,0,0,0,0,0,0,1,0,1,8,1,7
2426,151,815,268,547,5,542,7,535,181,159,102,41,36,5,0,0,0,0,0,2,0,0,0,1,2,0,6
2427,151,944,398,546,5,541,6,535,158,166,130,35,14,9,1,0,0,0,1,0,0,0,3,0,13,0,5
2428,151,668,277,391,1,390,1,389,113,114,94,35,13,6,0,1,0,1,1,0,0,0,0,0,5,2,4
2429,151,973,383,590,3,587,10,577,121,228,115,44,34,11,4,1,0,0,0,0,1,0,2,1,9,1,5
2430,151,688,211,477,4,473,6,467,133,157,97,41,22,4,0,0,1,0,0,2,0,1,0,1,4,2,2
2431,151,753,303,450,7,443,6,437,110,123,128,35,18,8,0,1,0,0,0,0,0,0,0,1,8,0,5
2432,151,896,326,570,1,569,6,563,158,176,128,53,25,6,0,0,1,0,0,0,0,1,0,2,10,0,3
2433,151,610,247,363,1,362,3,359,124,111,65,27,20,6,0,0,0,0,0,0,0,2,0,1,2,1,0
2434,151,903,366,537,5,532,3,529,171,198,96,40,8,10,3,0,0,0,0,1,0,0,0,0,0,0,2
2435,151,651,246,405,4,401,6,395,146,113,68,32,18,8,1,0,0,0,0,0,0,0,2,0,4,1,2
2436,151,649,239,410,1,409,2,407,149,119,66,39,21,9,0,0,0,0,0,0,0,0,0,0,2,0,2
2437,151,620,232,388,0,388,2,386,136,108,97,16,10,5,0,2,1,1,0,2,0,0,0,0,2,2,4
2438,151,739,276,463,2,461,6,455,147,118,95,51,27,6,0,0,2,0,0,1,0,0,1,1,3,1,2
2439,151,589,219,370,2,368,2,366,97,125,67,44,14,5,0,0,1,0,0,0,1,0,2,0,4,0,6
2440,151,874,309,565,4,561,2,559,146,201,109,43,33,15,1,0,0,2,0,0,0,0,0,0,4,0,5
2441,151,608,197,411,6,405,6,399,109,141,81,40,17,3,0,0,0,0,0,1,0,0,0,0,2,1,4
2442,151,559,211,348,8,340,2,338,78,121,68,31,23,3,0,0,0,1,0,1,0,1,3,1,1,0,6
2443,151,801,256,545,7,538,6,532,167,138,128,52,18,11,0,0,0,2,0,0,0,0,1,1,6,0,8
2444,151,523,155,368,3,365,6,359,131,96,68,29,21,2,0,0,0,1,0,0,0,0,0,2,5,0,4
2445,151,508,142,366,1,365,6,359,124,100,60,35,16,11,0,0,0,0,0,0,1,0,3,1,5,3,0
2446,151,672,248,424,6,418,2,416,144,136,71,29,20,6,0,0,0,0,0,0,0,0,0,0,4,1,5
2447,151,694,243,451,4,447,4,443,166,117,79,32,16,18,1,0,0,0,1,0,1,0,2,1,3,0,6
2448,151,726,207,519,2,517,8,509,250,93,66,54,15,13,0,0,0,0,1,0,0,0,0,0,5,1,11
2449,151,915,316,599,8,591,8,583,252,154,83,48,24,4,2,1,0,0,1,0,0,3,1,0,7,0,3
2450,151,978,215,763,1,762,8,754,338,179,85,79,48,9,0,0,0,0,0,2,0,1,0,1,5,0,7
2451,151,861,227,634,3,631,3,628,296,137,80,63,18,16,0,0,0,0,0,1,0,0,0,0,5,0,12
2452,151,952,274,678,8,670,6,664,285,163,80,65,22,19,1,1,0,0,0,0,0,1,1,4,9,0,13
2453,151,497,157,340,3,337,6,331,123,110,39,31,10,5,0,0,0,0,0,0,0,0,1,0,3,1,8
2454,151,548,215,333,0,333,0,333,138,101,36,35,8,3,0,0,0,0,1,0,0,1,0,1,2,0,7
2455,151,667,237,430,8,422,6,416,145,94,102,33,22,3,2,0,0,0,1,0,0,1,0,1,10,1,1
2456,151,919,296,623,3,620,4,616,214,173,118,72,21,9,2,0,0,0,0,0,0,0,0,1,4,0,2
2457,151,683,237,446,2,444,4,440,149,119,78,57,20,8,0,0,0,0,1,1,0,0,1,1,2,0,3
2458,151,940,351,589,7,582,3,579,212,148,100,69,28,8,1,0,0,0,0,1,0,2,0,0,5,0,5
2459,151,675,238,437,9,428,5,423,135,107,89,45,26,10,0,0,0,0,0,0,0,0,0,0,5,0,6
2460,151,633,222,411,6,405,4,401,141,111,71,39,22,2,1,1,0,0,0,0,0,1,0,2,5,1,4
2461,151,615,238,377,1,376,4,372,119,124,61,33,19,9,0,0,0,1,0,1,0,1,0,0,3,0,1
2462,151,574,217,357,2,355,3,352,131,95,55,33,20,6,1,0,0,0,1,0,0,1,0,0,7,0,2
2463,151,572,220,352,4,348,2,346,125,112,54,29,11,6,0,0,0,0,0,0,0,0,0,0,6,0,3
2464,151,537,200,337,0,337,4,333,130,85,63,23,13,4,0,0,0,0,0,0,0,1,0,2,5,4,3
2465,151,599,216,383,1,382,4,378,133,104,62,45,13,6,2,1,0,0,1,0,0,0,0,1,5,2,3
2466,151,531,207,324,1,323,2,321,101,88,65,30,20,5,0,0,0,0,0,0,0,1,1,0,5,0,5
2467,151,692,202,490,1,489,1,488,136,148,113,48,24,9,0,0,0,0,0,0,0,1,0,0,5,0,4
2468,151,643,220,423,6,417,2,415,123,118,85,43,28,4,0,0,0,0,0,0,0,0,0,0,10,0,4
2469,151,946,347,599,8,591,3,588,199,183,106,46,29,15,1,0,1,0,0,0,0,1,0,1,2,1,3
2470,152,543,164,379,5,374,3,371,136,92,53,47,23,8,0,0,0,0,0,3,0,0,0,2,1,1,5
2471,152,511,169,342,5,337,4,333,145,77,57,18,22,8,0,0,0,0,0,0,0,0,0,0,2,2,2
2472,152,950,337,613,10,603,4,599,223,179,106,50,23,11,0,1,0,0,0,0,0,0,0,0,3,0,3
2473,152,562,249,313,2,311,1,310,95,103,57,29,14,7,0,0,0,0,0,0,0,0,0,0,1,2,2
2474,152,531,193,338,5,333,1,332,111,98,58,34,20,2,0,0,0,1,0,0,1,0,0,1,1,3,2
2475,152,750,289,461,6,455,1,454,165,126,86,42,15,8,1,0,0,1,0,1,0,4,0,0,4,0,1
2476,152,947,381,566,7,559,4,555,222,131,100,48,27,15,0,0,0,0,0,0,0,0,3,0,4,0,5
2477,152,950,390,560,3,557,5,552,154,177,121,43,33,11,1,0,0,0,0,2,0,0,1,2,0,3,4
2478,152,997,366,631,13,618,9,609,239,160,100,62,24,2,0,0,1,1,0,0,0,0,0,5,5,3,7
2479,152,589,212,377,9,368,2,366,111,117,72,43,13,1,0,0,0,0,0,0,1,0,1,2,3,0,2
2480,152,652,198,454,3,451,3,448,122,144,110,40,25,4,0,0,0,0,0,0,0,0,0,0,0,0,3
2481,152,522,197,325,3,322,3,319,90,68,75,43,23,12,0,0,0,0,0,0,0,0,0,0,7,0,1
2482,152,525,213,312,4,308,4,304,96,88,53,37,11,9,0,0,0,0,0,0,2,0,0,0,3,2,3
2483,152,550,212,338,3,335,2,333,91,108,70,31,16,8,2,0,0,1,0,0,0,0,0,0,1,1,4
2484,152,552,185,367,4,363,5,358,131,98,71,26,18,3,4,0,0,0,0,0,0,0,0,0,7,0,0
2485,152,570,205,365,5,360,6,354,129,102,61,36,16,4,0,0,0,0,0,0,0,1,0,0,5,0,0
2486,152,573,190,383,4,379,4,375,136,98,69,38,18,6,1,0,1,0,0,0,0,0,0,1,4,0,3
2487,152,554,207,347,0,347,2,345,125,96,55,33,15,10,1,0,0,0,0,0,0,0,0,0,4,0,6
2488,152,513,205,308,6,302,4,298,105,101,44,19,16,5,0,0,0,0,0,1,0,0,0,0,5,0,2
2489,152,508,207,301,7,294,3,291,102,83,43,44,10,3,0,0,0,0,0,0,0,0,0,0,6,0,0
2490,152,851,350,501,14,487,7,480,140,147,110,38,21,17,1,0,0,1,0,0,0,0,0,0,3,1,1
2491,152,666,263,403,4,399,7,392,120,123,71,34,18,7,1,0,0,1,0,0,1,1,0,2,12,0,1
2492,152,821,352,469,5,464,5,459,147,130,94,48,19,5,0,0,0,1,1,0,0,0,0,1,12,0,1
2493,152,533,174,359,4,355,3,352,110,118,67,28,12,4,0,0,0,0,1,0,1,1,0,0,4,2,4
2494,152,548,197,351,2,349,5,344,124,91,69,33,18,2,0,0,0,0,0,0,0,0,1,1,4,1,0
2495,152,837,264,573,5,568,3,565,174,165,98,71,31,12,1,0,0,0,0,0,0,1,0,1,7,0,4
2496,152,882,293,589,4,585,1,584,175,176,100,78,25,12,1,0,0,0,0,0,0,1,1,0,6,1,8
2497,152,547,175,372,5,367,4,363,127,96,57,50,19,10,0,0,0,0,0,0,0,0,0,0,2,0,2
2498,152,590,179,411,6,405,5,400,118,119,74,49,14,14,1,0,0,0,3,0,0,1,0,1,2,0,4
2499,152,588,172,416,4,412,3,409,162,126,79,30,0,7,1,0,0,0,0,0,0,0,0,0,3,0,1
2500,152,837,194,643,8,635,5,630,207,203,116,53,30,6,0,0,0,0,0,0,0,1,0,0,7,0,7
2501,152,517,113,404,6,398,4,394,113,107,90,48,16,13,0,0,0,0,0,1,0,0,0,0,2,1,3
2502,152,505,128,377,5,372,5,367,112,102,80,38,19,6,0,0,0,0,0,0,0,0,0,0,6,0,4
2503,152,713,190,523,5,518,2,516,172,140,75,78,27,13,0,0,0,0,0,0,0,0,0,0,7,2,2
2504,152,661,165,496,6,490,0,490,170,135,76,67,22,9,0,0,0,2,1,0,0,0,0,0,3,1,4
2505,152,743,170,573,8,565,3,562,179,169,99,61,25,13,2,2,0,0,0,0,2,1,0,2,4,0,3
2506,152,821,193,628,3,625,13,612,203,174,109,65,30,14,2,0,0,0,0,1,1,2,1,0,2,1,7
2507,152,486,204,282,4,278,2,276,66,78,80,27,16,2,1,0,0,0,0,0,0,0,0,1,3,0,2
2508,152,538,228,310,3,307,0,307,84,95,71,19,16,4,1,1,0,1,1,0,1,1,0,0,7,0,5
2509,152,831,361,470,4,466,3,463,118,153,105,45,20,7,0,2,0,0,0,1,2,0,0,2,2,0,6
2510,152,677,241,436,0,436,1,435,134,130,81,42,22,11,0,0,1,2,0,2,1,1,0,0,7,0,1
2511,152,633,225,408,5,403,3,400,134,121,78,31,19,10,0,0,1,0,0,1,0,1,2,0,1,0,1
2512,152,552,197,355,7,348,4,344,111,118,60,22,17,7,0,1,0,1,0,0,0,0,1,0,2,0,4
2513,152,582,169,413,7,406,3,403,136,130,74,31,17,2,0,1,1,1,0,0,0,0,0,0,7,0,3
2514,152,738,264,474,2,472,4,468,167,140,82,47,17,7,0,0,0,0,0,0,0,2,1,0,2,2,1
2515,152,854,279,575,6,569,9,560,172,164,104,56,33,15,0,0,0,1,0,0,1,1,1,1,4,3,4
2516,152,619,251,368,4,364,6,358,80,120,93,28,20,7,0,0,0,0,0,1,0,2,2,1,2,1,1
2517,152,579,239,340,0,340,0,340,88,114,69,21,20,9,1,0,0,0,3,0,0,0,4,0,5,0,6
2518,152,643,312,331,2,329,3,326,53,105,97,29,20,13,0,0,0,1,0,0,0,0,0,3,3,1,1
2519,152,534,228,306,0,306,3,303,78,94,55,31,17,7,1,0,1,1,0,5,0,0,0,2,7,1,3
2520,152,559,246,313,6,307,3,304,81,105,52,35,19,3,1,1,0,0,0,1,0,0,0,0,3,1,2
2521,152,996,285,711,5,706,9,697,286,186,115,59,24,15,0,0,0,1,0,0,0,0,0,2,2,0,7
2522,152,971,420,551,5,546,3,543,171,155,122,43,27,7,0,0,0,0,3,0,0,1,1,0,4,1,8
2523,152,735,265,470,8,462,1,461,161,142,88,30,27,5,0,0,2,0,0,0,0,0,0,0,0,2,4
2524,152,528,245,283,3,280,2,278,117,80,34,23,10,5,0,0,0,2,0,0,0,0,0,0,4,1,2
2525,152,526,218,308,4,304,5,299,123,84,36,29,11,2,0,0,0,0,0,0,0,0,0,0,6,0,8
2526,152,793,262,531,3,528,12,516,200,121,87,48,24,17,0,0,1,1,0,1,0,0,0,1,7,1,7
2527,152,806,332,474,7,467,2,465,115,146,108,37,26,16,0,1,0,0,0,0,2,0,2,1,7,0,4
2528,152,782,312,470,5,465,5,460,152,129,94,32,26,8,1,3,0,3,0,0,1,0,0,1,6,2,2
2529,152,874,336,538,3,535,5,530,203,153,83,48,21,10,1,0,0,0,0,0,0,1,0,1,6,1,2
2530,152,727,185,542,7,535,4,531,170,159,84,53,35,12,0,1,0,0,2,0,0,1,0,1,4,2,7
2531,152,808,218,590,3,587,6,581,183,182,112,54,21,19,1,0,0,0,0,0,1,0,2,0,4,0,2
2532,152,490,127,363,2,361,1,360,105,112,57,45,24,12,0,0,0,0,0,0,0,0,0,0,1,1,3
2533,152,528,139,389,1,388,1,387,118,112,63,49,23,17,0,0,0,0,0,0,0,0,0,0,3,1,1
2534,152,633,151,482,0,482,1,481,151,139,95,57,26,9,0,0,0,0,0,0,0,1,0,0,2,0,1
2535,152,633,148,485,8,477,9,468,156,135,85,49,28,6,0,0,1,0,0,1,0,0,0,1,3,2,1
2536,152,978,269,709,5,704,8,696,217,204,114,100,37,10,1,1,0,0,1,0,0,0,0,3,5,1,2
2537,153,652,171,481,4,477,6,471,235,115,41,49,9,5,1,0,0,2,0,0,0,0,0,0,3,1,10
2538,153,581,179,402,2,400,5,395,161,106,58,38,10,11,0,0,0,0,0,0,0,0,0,1,4,0,6
2539,153,1013,368,645,7,638,3,635,232,185,99,72,24,15,1,0,0,0,0,1,0,0,0,0,4,1,1
2540,153,540,177,363,1,362,3,359,124,111,68,25,12,7,0,0,0,0,0,0,0,1,0,1,2,1,7
2541,153,536,206,330,3,327,2,325,112,76,79,27,10,3,1,2,0,0,0,0,0,1,1,2,3,1,7
2542,153,639,238,401,5,396,4,392,134,111,75,36,24,4,0,0,0,0,0,1,0,1,0,0,0,2,4
2543,153,996,311,685,8,677,8,669,265,171,109,61,36,12,1,0,0,0,0,0,0,3,2,0,4,0,5
2544,153,646,230,416,4,412,5,407,140,127,72,36,15,5,0,0,0,0,0,0,0,1,0,1,5,4,1
2545,153,752,229,523,7,516,6,510,163,136,97,58,23,7,0,0,0,2,1,1,2,0,0,1,11,2,6
2546,153,524,202,322,2,320,1,319,121,82,58,28,17,5,0,0,0,0,0,0,0,0,0,0,6,1,1
2547,153,493,190,303,3,300,5,295,118,74,37,33,13,3,0,0,0,2,0,0,0,0,0,1,9,0,5
2548,153,588,204,384,4,380,5,375,129,112,56,40,10,15,0,0,0,0,0,0,0,1,1,2,1,0,8
2549,153,772,291,481,5,476,2,474,139,141,102,52,21,15,0,0,0,1,0,0,0,0,1,0,2,0,0
2550,153,731,280,451,0,451,0,451,140,152,75,43,20,8,0,1,0,0,0,0,0,1,0,0,4,1,6
2551,153,919,394,525,4,521,3,518,173,140,90,61,32,7,0,0,0,0,1,0,0,2,0,1,5,2,4
2552,153,553,168,385,4,381,1,380,129,108,68,40,16,4,1,0,1,0,0,1,0,0,0,1,6,2,3
2553,153,560,204,356,1,355,5,350,120,91,63,38,20,9,0,0,0,1,0,1,0,0,0,2,3,0,2
2554,153,510,180,330,2,328,6,322,102,101,62,29,9,3,0,0,0,0,0,2,0,1,3,0,6,0,4
2555,153,974,335,639,2,637,6,631,227,147,118,64,0,16,0,0,0,0,2,33,0,0,0,2,11,1,10
2556,153,723,244,479,1,478,7,471,198,106,84,45,19,10,0,0,0,0,0,0,0,1,0,0,0,0,8
2557,153,499,163,336,2,334,5,329,120,81,60,41,12,5,0,0,0,0,0,1,0,1,0,1,2,0,5
2558,153,561,172,389,5,384,2,382,142,88,70,42,14,11,1,0,0,0,0,1,0,0,0,0,2,2,9
2559,153,700,247,453,2,451,3,448,125,116,109,44,32,10,0,1,0,0,1,1,0,0,0,1,5,0,3
2560,153,643,190,453,5,448,5,443,160,112,86,37,20,9,0,0,0,0,0,1,1,0,0,0,5,1,11
2561,153,1008,329,679,6,673,4,669,244,146,139,78,34,15,0,1,0,0,0,0,0,0,0,2,6,0,4
2562,153,530,178,352,0,352,3,349,122,104,53,45,11,6,0,0,0,1,0,0,0,3,1,0,2,0,1
2563,153,516,227,289,4,285,3,282,119,70,58,0,13,5,1,0,0,0,0,0,1,2,2,0,5,0,6
2564,154,669,228,441,0,441,3,438,186,112,60,49,16,3,0,0,0,0,0,0,0,1,0,2,3,2,4
2565,154,659,230,429,4,425,5,420,183,96,51,56,12,10,0,0,0,0,0,0,0,0,2,1,1,0,8
2566,154,725,223,502,3,499,4,495,202,115,74,59,16,17,1,0,0,0,0,1,0,1,0,0,5,0,4
2567,154,823,294,529,8,521,5,516,224,125,63,62,15,7,1,0,0,1,0,4,0,0,0,0,7,0,7
2568,154,987,361,626,5,621,4,617,267,163,79,60,15,13,1,3,0,0,0,2,2,0,0,0,7,1,4
2569,154,729,271,458,1,457,7,450,206,109,68,35,17,6,0,0,0,0,0,0,1,0,0,0,4,1,3
2570,154,809,292,517,1,516,1,515,169,157,113,41,22,9,0,0,0,0,0,0,0,0,0,0,2,0,2
2571,154,647,267,380,5,375,2,373,153,111,56,30,10,5,1,0,0,0,0,0,1,0,0,1,3,0,2
2572,154,571,198,373,2,371,3,368,143,87,57,50,12,4,0,1,0,0,1,0,0,1,1,2,4,0,5
2573,154,865,241,624,2,622,7,615,225,166,122,56,17,13,2,0,0,0,1,1,0,0,0,0,6,2,4
2574,154,879,241,638,10,628,6,622,225,153,115,74,29,10,0,0,0,1,0,0,1,1,0,1,5,0,7
2575,154,720,208,512,0,512,0,512,190,129,73,59,16,17,0,0,0,1,0,0,0,1,1,2,9,2,12
2576,154,661,163,498,3,495,14,481,197,109,69,48,18,6,1,0,0,0,0,0,2,0,0,1,5,0,25
2577,154,922,324,598,5,593,5,588,205,164,117,56,20,9,0,1,0,1,1,1,0,1,0,2,8,1,1
2578,154,604,205,399,2,397,5,392,157,95,55,53,8,10,0,0,0,0,0,0,0,0,0,0,2,2,10
2579,154,658,215,443,1,442,6,436,174,88,64,64,19,10,0,0,0,1,0,1,0,0,1,0,7,1,6
2580,154,880,217,663,3,660,5,655,305,130,75,101,20,11,0,0,0,0,0,1,0,1,1,0,5,0,5
2581,154,761,183,578,2,576,6,570,265,117,60,85,20,7,1,0,0,0,0,1,0,0,0,1,4,0,9
2582,154,705,204,501,8,493,6,487,158,140,81,53,24,12,0,2,0,0,0,0,0,2,1,0,5,1,8
2583,154,763,241,522,7,515,4,511,170,136,114,51,22,12,0,0,0,0,0,0,0,0,0,0,3,0,3
2584,154,741,228,513,1,512,4,508,213,105,95,43,22,13,1,1,0,1,0,1,0,1,0,1,6,0,5
2585,155,530,147,383,1,382,4,378,97,110,97,34,23,8,0,0,0,0,0,0,0,0,2,0,2,0,5
2586,155,565,164,401,1,400,2,398,103,133,84,43,22,4,0,0,0,0,0,2,0,1,1,0,3,0,2
2587,155,640,209,431,2,429,7,422,85,166,71,49,23,14,1,0,0,0,0,0,1,1,1,1,7,2,0
2588,155,685,198,487,3,484,6,478,118,166,100,46,26,9,0,0,0,0,0,0,0,0,0,0,8,0,5
2589,155,867,214,653,4,649,4,645,236,185,111,58,29,11,0,1,0,0,0,0,0,0,1,2,5,0,6
2590,155,822,282,540,10,530,12,518,143,178,88,48,30,15,0,0,0,0,0,1,0,0,0,1,8,0,6
2591,155,928,306,622,4,618,4,614,157,227,117,60,25,13,1,1,0,0,1,0,0,0,1,0,8,0,3
2592,155,776,239,537,5,532,5,527,197,139,86,49,29,14,0,0,0,1,0,0,0,0,0,1,5,0,6
2593,155,945,316,629,4,625,9,616,238,183,77,56,28,12,2,1,0,2,1,0,0,0,0,0,6,2,8
2594,155,533,149,384,7,377,6,371,164,77,50,54,10,3,0,0,0,0,1,1,1,0,0,0,2,2,6
2595,155,573,183,390,1,389,4,385,128,107,67,57,9,5,0,0,0,0,0,0,0,0,0,0,7,0,5
2596,155,908,264,644,3,641,7,634,214,178,94,88,28,14,1,0,0,0,0,2,0,2,0,1,5,2,5
2597,155,997,207,790,2,788,8,780,394,184,66,86,22,11,0,0,0,0,0,1,0,0,0,0,7,0,9
2598,155,752,158,594,7,587,2,585,305,103,48,86,14,9,0,0,0,1,0,0,0,0,0,0,2,0,17
2599,155,737,176,561,0,561,7,554,283,82,57,84,16,14,0,1,0,2,0,0,0,0,0,0,4,0,11
2600,155,654,140,514,0,514,5,509,237,123,49,69,11,4,1,0,0,0,2,3,0,0,0,0,3,0,7
2601,155,706,161,545,4,541,5,536,252,107,41,98,16,10,0,0,0,0,0,0,0,1,0,1,4,0,6
2602,155,541,135,406,1,405,1,404,221,63,41,56,3,13,0,0,1,0,0,1,0,0,0,0,0,1,4
2603,155,854,210,644,3,641,2,639,303,124,64,106,13,10,0,0,0,0,0,0,1,0,0,2,5,0,11
2604,155,627,139,488,3,485,12,473,302,57,24,56,7,11,0,0,0,0,0,0,0,0,0,0,3,0,13
2605,156,767,182,585,4,581,5,576,247,130,104,53,13,15,0,0,0,1,0,0,0,1,0,1,1,1,9
2606,156,558,127,431,6,425,7,418,183,86,60,56,12,11,0,0,0,0,0,0,0,0,0,0,4,0,6
2607,156,556,142,414,2,412,3,409,182,88,55,45,14,12,0,0,0,1,0,0,0,0,1,1,5,0,5
2608,156,640,140,500,4,496,9,487,270,93,19,74,7,11,1,1,0,0,0,0,0,0,0,0,5,0,6
2609,156,583,150,433,0,433,5,428,246,76,24,54,12,4,0,0,0,0,0,0,0,0,0,0,2,0,10
2610,156,576,121,455,4,451,7,444,205,92,44,66,18,9,0,1,0,0,1,1,0,0,0,0,1,1,5
2611,156,611,126,485,3,482,5,477,204,99,70,62,11,13,0,0,0,0,0,0,0,1,0,1,2,1,13
2612,156,601,112,489,4,485,9,476,240,98,33,58,18,7,0,0,1,1,0,0,0,0,0,0,3,0,17
2613,156,543,132,411,1,410,7,403,223,63,35,47,12,5,0,0,0,1,0,0,0,0,0,0,1,0,16
2614,156,514,112,402,1,401,3,398,212,66,26,64,9,7,0,1,0,0,3,0,0,0,0,0,3,0,7
2615,156,913,208,705,0,705,7,698,268,166,128,68,41,15,0,0,0,0,0,0,0,1,0,1,5,0,5
2616,156,481,102,379,1,378,1,377,144,85,37,77,9,14,0,0,0,0,0,0,1,0,0,2,5,0,3
2617,156,532,111,421,3,418,7,411,175,93,37,73,10,14,0,0,0,0,0,0,0,1,0,0,3,1,4
2618,156,732,207,525,3,522,8,514,218,113,57,84,12,8,0,0,0,0,0,2,0,0,0,1,4,1,14
2619,156,756,160,596,5,591,15,576,261,107,63,101,19,12,0,1,0,0,0,0,0,0,0,0,6,1,5
2620,157,832,226,606,4,602,7,595,224,156,54,99,25,18,2,1,0,0,0,0,1,0,0,0,7,1,7
2621,157,546,122,424,4,420,4,416,201,101,37,49,11,5,0,0,0,0,1,0,0,1,0,0,2,0,8
2622,157,569,140,429,4,425,4,421,209,71,40,62,16,14,0,0,0,0,1,0,0,0,0,0,2,0,6
2623,157,987,272,715,7,708,5,703,287,175,81,111,18,11,0,0,0,0,0,0,0,1,0,2,9,1,7
2624,157,727,189,538,3,535,12,523,252,103,50,76,22,6,0,1,0,0,1,1,0,0,0,0,1,0,10
2625,157,940,234,706,3,703,10,693,335,133,71,103,13,10,0,1,0,1,1,2,0,1,0,0,3,0,19
2626,158,564,139,425,3,422,10,412,231,79,24,49,13,4,1,1,0,0,1,0,0,0,0,0,0,0,9
2627,158,589,180,409,3,406,3,403,221,66,25,56,14,2,2,1,0,0,1,0,0,0,0,1,4,1,9
2628,159,776,215,561,1,560,11,549,324,59,34,94,9,6,0,2,0,0,0,0,0,0,0,2,0,0,19
2629,159,695,202,493,6,487,3,484,304,52,31,64,7,7,1,0,0,0,0,0,0,1,0,2,3,0,12
2630,159,819,219,600,1,599,6,593,362,62,34,93,8,13,0,1,0,0,4,2,0,0,0,2,1,0,11
2631,159,791,248,543,6,537,5,532,320,57,21,109,9,5,0,0,0,0,0,0,0,0,0,0,1,0,10
2632,159,759,195,564,8,556,0,556,331,70,30,73,10,10,0,1,0,0,0,0,0,0,0,3,0,0,28
2633,159,796,198,598,7,591,9,582,340,87,28,72,14,14,0,3,0,0,0,0,0,0,2,1,2,0,19
2634,159,937,205,732,2,730,5,725,393,122,50,113,11,11,1,1,0,0,1,0,0,0,0,0,2,0,20
2635,159,900,176,724,5,719,5,714,420,104,40,98,14,11,0,1,1,0,0,0,0,1,0,1,1,0,22
2636,159,816,188,628,1,627,6,621,384,88,25,86,14,4,0,0,0,1,0,0,0,0,1,1,0,0,17
2637,159,691,155,536,2,534,1,533,304,77,48,74,8,4,0,3,0,0,0,0,0,0,0,3,2,0,10
2638,159,840,181,659,1,658,12,646,431,68,20,90,3,5,2,0,0,0,0,0,0,0,0,0,3,0,24
2639,159,585,117,468,1,467,4,463,267,73,22,68,3,3,0,0,0,0,0,0,0,0,0,0,2,0,25
2640,159,659,148,511,5,506,6,500,278,70,22,86,6,7,0,0,1,0,0,0,0,0,0,0,2,0,28
2641,159,862,193,669,2,667,11,656,389,89,26,117,11,8,0,1,0,0,0,0,0,1,0,0,3,0,11
2642,159,765,170,595,2,593,6,587,325,91,21,95,9,9,1,2,0,1,0,0,1,3,1,2,1,0,25
2643,159,508,195,313,0,313,5,308,68,125,58,35,9,4,0,0,0,0,0,0,0,0,1,1,3,0,4
2644,159,518,221,297,2,295,9,286,70,102,59,37,8,4,0,0,0,0,2,0,0,0,0,0,3,0,1
2645,159,896,183,713,10,703,9,694,380,123,40,83,19,11,0,0,0,0,0,0,0,1,0,1,6,0,30
2646,159,696,187,509,2,507,8,499,279,67,22,84,9,15,0,1,0,0,0,0,0,0,1,0,3,0,18
2647,159,744,190,554,2,552,4,548,296,92,31,90,11,7,1,1,0,0,0,0,0,0,0,2,1,0,16
2648,159,669,180,489,2,487,5,482,197,104,50,84,16,6,0,2,0,0,0,0,0,0,0,1,5,1,16
2649,159,692,145,547,4,543,6,537,227,112,58,92,16,10,0,1,0,0,0,0,0,2,0,1,3,0,15
2650,159,640,162,478,2,476,2,474,225,75,57,72,17,11,0,0,0,0,1,0,0,0,0,1,0,0,15
2651,161,672,150,522,4,518,6,512,269,79,49,86,9,8,0,0,0,0,1,0,2,0,0,0,4,1,4
2652,161,674,160,514,0,514,5,509,278,93,39,67,8,7,1,0,0,0,0,0,0,0,1,0,5,0,10
2653,161,543,143,400,3,397,2,395,231,50,15,72,12,4,0,0,0,0,0,0,0,0,0,0,2,0,9
2654,161,583,139,444,0,444,7,437,240,56,11,104,7,8,0,0,0,0,0,1,0,0,0,2,3,0,5
2655,161,515,112,403,3,400,6,394,226,63,19,54,7,6,0,0,0,0,0,1,0,0,0,1,5,0,12
2656,161,501,112,389,2,387,5,382,230,54,23,55,4,4,0,0,0,0,0,0,0,0,0,0,2,0,10
2657,161,535,112,423,5,418,1,417,221,71,27,82,6,4,0,1,0,0,1,0,0,0,0,0,0,0,4
2658,161,595,154,441,2,439,5,434,241,71,29,67,10,3,0,0,0,0,0,0,1,0,1,1,0,0,10
2659,162,673,184,489,2,487,4,483,289,55,23,95,4,9,1,0,0,0,0,0,1,0,0,0,2,0,4
2660,162,676,172,504,0,504,0,504,257,89,23,112,6,5,0,0,0,0,0,0,0,0,0,2,3,0,7
2661,162,737,181,556,2,554,4,550,388,60,16,67,4,5,0,2,0,0,0,0,0,1,0,0,1,0,6
2662,162,696,181,515,2,513,1,512,372,41,15,63,4,4,0,1,0,0,0,0,0,1,0,0,0,0,11
2663,162,678,186,492,3,489,5,484,217,114,48,55,27,13,0,0,0,0,0,0,0,0,0,0,1,0,9
2664,162,700,172,528,0,528,5,523,224,112,63,71,33,12,0,1,0,0,0,0,0,0,1,0,1,0,5
2665,162,730,194,536,3,533,5,528,306,75,20,93,6,11,1,0,0,0,0,0,0,1,0,2,1,0,12
2666,162,786,236,550,4,546,3,543,315,81,20,84,12,6,2,0,0,0,0,0,0,0,0,1,5,0,17
2667,162,615,169,446,2,444,2,442,310,57,15,46,3,4,0,0,0,0,1,0,0,0,0,0,0,0,6
2668,162,673,205,468,1,467,2,465,300,60,17,68,2,5,0,0,0,0,0,0,0,0,0,1,2,0,10
2669,162,854,187,667,6,661,5,656,182,192,138,88,23,15,0,1,0,0,1,0,0,1,1,2,5,2,5
2670,162,811,208,603,4,599,7,592,167,150,134,88,19,16,0,0,0,0,0,0,0,2,0,0,7,0,9
2671,162,522,132,390,1,389,3,386,236,47,19,63,7,2,0,2,0,0,0,1,0,0,0,0,1,0,8
2672,162,531,136,395,0,395,1,394,233,57,17,69,6,5,0,0,0,0,0,0,0,0,0,0,0,0,7
2673,163,603,183,420,0,420,3,417,175,100,44,72,12,4,0,1,0,0,1,0,0,0,0,0,1,1,6
2674,163,778,229,549,1,548,7,541,227,126,62,74,20,18,0,1,0,0,3,1,1,0,1,0,2,0,5
2675,163,773,205,568,5,563,9,554,239,118,78,72,18,9,0,1,1,0,0,1,0,0,0,1,1,1,14
2676,163,806,192,614,9,605,12,593,268,130,77,70,15,11,0,0,0,0,1,0,0,1,2,1,2,0,15
2677,163,852,294,558,7,551,4,547,123,201,130,39,32,9,0,0,0,0,0,0,0,0,1,2,3,4,3
2678,163,762,276,486,4,482,4,478,110,155,104,42,38,13,0,0,0,0,0,2,0,1,0,0,6,4,3
2679,163,978,334,644,5,639,7,632,190,195,136,59,27,8,1,1,0,0,0,2,0,0,0,1,5,1,6
2680,163,589,190,399,4,395,6,389,97,148,85,24,14,9,0,0,1,0,0,0,0,2,2,0,3,1,3
2681,163,916,248,668,3,665,6,659,210,200,103,73,41,15,0,1,0,1,0,0,0,1,0,1,6,0,7
2682,163,723,162,561,1,560,9,551,225,170,77,38,19,10,0,0,0,0,0,2,0,0,3,0,2,0,5
2683,163,1014,284,730,2,728,8,720,230,227,115,85,27,14,2,1,0,0,1,0,0,0,2,1,10,0,5
2684,163,861,250,611,4,607,6,601,198,178,116,56,33,7,0,0,0,0,0,0,1,0,0,2,3,0,7
2685,163,875,226,649,6,643,5,638,227,198,103,64,24,16,0,0,0,0,0,2,0,1,0,0,2,1,0
2686,163,689,162,527,3,524,2,522,199,161,62,62,27,4,0,1,0,0,0,0,0,1,1,0,1,0,3
2687,163,787,211,576,0,576,6,570,178,199,99,52,14,16,0,0,0,1,1,1,0,1,0,0,1,1,6
2688,163,534,146,388,2,386,12,374,116,131,52,37,15,13,0,0,0,0,0,1,0,0,0,0,4,0,5
2689,163,484,124,360,2,358,3,355,116,99,59,39,20,11,0,0,0,0,0,0,0,0,0,0,2,1,8
2690,163,999,266,733,7,726,3,723,296,190,101,78,16,22,0,0,0,0,0,0,0,2,0,1,6,0,11
2691,163,593,162,431,6,425,5,420,146,100,92,46,14,7,1,1,0,0,1,0,1,0,0,1,5,0,5
2692,163,577,158,419,5,414,3,411,176,90,65,43,16,7,2,1,0,0,0,0,0,0,0,0,3,1,7
2693,163,817,204,613,7,606,1,605,157,199,115,79,26,14,0,0,0,0,0,1,1,3,1,0,5,0,4
2694,163,799,216,583,8,575,6,569,148,198,95,71,31,10,1,0,0,0,0,0,0,0,4,0,5,3,3
2695,163,813,211,602,7,595,9,586,156,152,127,93,20,15,0,0,0,1,0,0,0,2,0,0,6,0,14
2696,163,831,225,606,4,602,1,601,185,161,111,87,29,13,0,0,0,0,0,0,0,2,1,1,2,0,9
2697,163,622,203,419,3,416,11,405,107,141,72,40,25,14,0,0,0,0,0,0,0,0,0,0,5,0,1
2698,163,609,171,438,1,437,9,428,162,129,69,32,20,10,0,0,0,3,0,0,0,0,0,0,3,0,0
2699,163,828,201,627,7,620,7,613,185,196,114,70,19,15,0,1,0,0,0,1,0,1,1,0,6,0,4
2700,163,994,275,719,1,718,8,710,218,241,137,58,26,13,0,0,0,0,1,0,0,0,0,2,6,4,4
2701,163,773,218,555,5,550,8,542,149,179,98,73,20,10,0,0,1,0,1,0,0,0,2,1,0,0,8
2702,163,746,200,546,3,543,6,537,154,196,79,52,24,17,0,0,0,0,0,0,0,0,0,1,9,0,5
2703,163,591,112,479,8,471,2,469,132,157,89,58,17,5,0,0,0,0,0,0,0,0,0,0,4,1,6
2704,163,627,129,498,3,495,5,490,140,149,102,59,19,7,1,1,0,0,0,0,0,0,0,0,8,2,2
2705,163,726,197,529,2,527,9,518,135,145,120,72,16,12,0,1,0,0,0,0,0,1,0,0,3,4,9
2706,163,700,171,529,4,525,5,520,115,168,112,72,20,17,0,0,0,0,1,1,0,0,0,1,5,0,8
2707,163,596,234,362,1,361,3,358,126,97,68,43,11,6,0,1,0,1,0,0,0,1,1,0,2,0,1
2708,163,568,197,371,3,368,5,363,125,107,72,34,12,9,0,0,0,0,0,0,0,0,0,0,0,1,3
2709,163,697,232,465,6,459,6,453,152,140,82,60,4,9,0,0,0,0,0,0,0,0,0,1,3,0,2
2710,163,681,228,453,0,453,4,449,163,120,68,57,18,7,0,2,0,0,0,1,1,1,0,0,4,1,6
2711,163,642,202,440,1,439,7,432,174,113,56,51,20,8,0,1,0,0,0,0,0,0,0,2,2,1,4
2712,163,620,190,430,1,429,0,429,166,85,72,58,25,11,0,0,0,0,0,0,0,1,0,1,3,0,7
2713,163,634,146,488,6,482,3,479,157,109,92,79,7,17,0,1,0,0,0,0,0,0,0,0,2,2,13
2714,163,634,163,471,3,468,2,466,158,116,74,79,6,19,0,2,0,0,0,0,0,1,0,0,2,2,7
2715,163,926,201,725,5,720,6,714,193,209,140,102,32,15,1,0,0,0,0,0,1,0,1,0,12,1,7
2716,163,590,141,449,4,445,4,441,123,131,76,69,23,9,0,0,0,0,0,0,0,1,0,1,3,0,5
2717,163,562,136,426,5,421,3,418,116,125,82,55,20,13,0,0,0,0,1,0,0,1,0,0,4,0,1
2718,164,867,224,643,5,638,6,632,318,95,43,130,14,14,0,0,0,0,0,0,0,0,0,1,0,0,17
2719,164,847,213,634,2,632,10,622,309,109,44,127,5,10,0,0,0,0,0,0,0,0,1,1,4,0,12
2720,164,824,274,550,6,544,5,539,189,161,89,39,25,12,0,2,1,0,1,0,1,3,0,0,6,0,10
2721,164,962,278,684,4,680,7,673,267,159,105,72,36,14,0,0,2,0,1,0,0,2,1,1,4,1,8
2722,164,830,286,544,12,532,3,529,147,168,114,49,23,13,1,0,1,0,0,1,1,1,0,1,5,2,2
2723,164,856,305,551,7,544,10,534,161,159,131,38,26,9,1,0,1,0,0,1,0,0,0,2,3,0,2
2724,164,538,205,333,1,332,4,328,104,99,65,38,2,8,1,0,0,0,0,0,0,1,0,1,5,2,2
2725,164,626,196,430,6,424,9,415,174,114,56,48,9,10,0,0,0,0,0,0,0,0,3,0,1,0,0
2726,164,708,230,478,10,468,5,463,171,126,84,42,20,11,0,0,0,1,1,1,0,0,0,0,5,0,1
2727,164,829,212,617,2,615,6,609,230,163,78,76,27,12,0,0,0,0,0,0,2,3,0,2,4,0,12
2728,164,609,143,466,2,464,6,458,157,113,71,73,16,14,0,0,0,0,0,0,1,2,0,2,4,0,5
2729,164,663,153,510,3,507,5,502,201,115,72,71,19,11,0,0,0,0,1,1,0,2,0,2,2,1,4
2730,164,767,192,575,6,569,6,563,227,144,84,67,13,11,0,0,0,0,1,0,0,0,1,1,3,0,11
2731,164,701,156,545,3,542,7,535,215,137,74,77,10,14,1,0,0,0,0,1,0,0,0,0,2,1,3
2732,164,528,118,410,5,405,6,399,166,116,53,34,11,6,1,0,0,0,0,2,1,1,0,0,2,0,6
2733,164,875,212,663,12,651,10,641,234,190,96,78,19,10,0,0,0,0,2,0,0,0,0,1,3,0,8
2734,164,930,244,686,4,682,7,675,186,216,103,94,34,20,0,1,0,0,2,1,2,0,0,1,5,0,10
2735,164,611,122,489,8,481,5,476,129,158,88,59,19,9,1,0,0,0,0,0,1,0,0,1,4,1,6
2736,164,536,127,409,2,407,13,394,126,105,70,54,20,11,0,0,0,0,0,0,0,0,0,0,2,5,1
2737,164,621,159,462,7,455,5,450,144,129,90,45,22,11,0,1,0,0,0,0,0,0,1,0,5,0,2
2738,164,666,194,472,3,469,1,468,142,134,97,59,17,11,0,0,0,0,0,0,0,0,0,0,5,1,2
2739,164,768,236,532,5,527,2,525,151,177,102,46,25,11,0,0,1,0,0,0,0,0,1,0,7,0,4
2740,164,920,290,630,5,625,5,620,203,168,130,68,22,14,0,0,0,0,0,1,0,2,3,0,6,0,3
2741,164,669,220,449,6,443,4,439,132,114,94,55,19,11,0,0,0,0,0,1,0,0,1,0,7,2,3
2742,164,668,217,451,5,446,4,442,145,125,103,42,19,4,0,0,0,0,0,0,0,0,0,0,1,0,3
2743,164,621,246,375,4,371,5,366,115,102,80,42,10,4,0,0,0,0,0,0,0,1,0,1,9,0,2
2744,164,547,225,322,3,319,0,319,82,94,88,31,9,5,0,0,0,0,0,0,0,0,0,2,4,2,2
2745,164,815,270,545,7,538,2,536,161,168,94,69,14,10,0,0,0,0,0,1,0,2,1,3,7,1,5
2746,164,556,217,339,3,336,5,331,108,87,62,38,17,7,0,0,0,0,0,0,0,1,0,0,7,1,3
2747,164,528,178,350,5,345,5,340,91,102,97,26,13,9,0,0,0,0,0,0,0,0,0,0,1,0,1
2748,164,743,219,524,2,522,8,514,161,159,85,52,26,15,0,1,0,1,1,1,2,0,0,0,3,2,5
2749,164,793,234,559,3,556,8,548,180,169,83,56,26,25,1,0,0,0,0,0,0,0,0,0,4,2,2
2750,164,665,190,475,1,474,6,468,179,138,74,45,12,3,0,1,0,0,2,1,0,4,0,0,1,1,7
2751,164,639,168,471,4,467,4,463,180,120,73,56,15,9,0,1,0,0,0,2,0,1,0,0,2,0,4
2752,164,636,132,504,5,499,4,495,210,120,74,51,15,8,0,0,0,0,0,1,0,1,0,3,2,1,9
2753,164,573,130,443,6,437,5,432,165,105,80,57,9,6,0,0,0,0,0,1,0,0,0,0,2,0,7
2754,164,512,131,381,7,374,5,369,144,91,66,38,12,8,0,0,0,0,0,0,0,1,0,2,4,0,3
2755,164,918,207,711,4,707,10,697,283,172,102,82,19,13,0,0,0,1,1,1,0,0,0,1,7,5,10
2756,164,960,282,678,4,674,10,664,274,167,101,67,29,10,0,1,0,0,0,0,1,0,0,0,5,0,9
2757,164,746,261,485,3,482,2,480,135,133,128,45,24,2,0,0,0,0,0,1,0,1,0,0,4,0,7
2758,164,775,258,517,7,510,5,505,153,142,118,42,28,1,0,1,0,0,1,0,0,0,0,3,9,0,7
2759,164,546,241,305,4,301,4,297,74,92,93,18,12,4,0,0,0,0,0,0,0,0,0,1,2,0,1
2760,164,528,202,326,2,324,0,324,88,90,88,26,13,8,0,0,0,0,0,0,0,1,0,1,4,1,4
2761,164,914,256,658,10,648,5,643,193,171,167,63,22,12,0,0,0,0,0,0,0,1,1,2,8,0,3
2762,164,687,156,531,4,527,6,521,143,157,102,73,14,11,2,1,0,0,1,2,0,2,0,0,5,0,8
2763,164,760,195,565,7,558,4,554,202,136,110,72,11,10,0,0,0,0,0,2,0,0,0,2,5,0,4
2764,164,568,205,363,4,359,5,354,51,145,99,23,14,12,2,0,0,1,1,1,0,0,0,2,3,0,0
2765,164,619,255,364,7,357,0,357,56,147,103,29,13,0,0,0,0,0,0,0,0,1,0,1,6,0,1
2766,164,813,354,459,2,457,0,457,55,188,164,17,9,6,0,0,2,0,0,8,0,0,1,1,5,0,1
2767,164,599,236,363,14,349,5,344,124,90,76,29,9,6,0,0,0,0,1,1,0,0,0,0,7,0,1
2768,164,530,219,311,1,310,4,306,89,109,60,26,8,5,0,0,0,0,0,0,0,0,1,1,5,0,2
2769,164,840,301,539,6,533,9,524,123,182,138,37,17,18,0,0,0,0,0,0,0,1,1,0,5,1,1
2770,164,938,295,643,3,640,9,631,208,194,104,71,27,8,1,0,0,1,0,0,1,2,2,2,2,2,6
2771,164,945,313,632,6,626,4,622,185,210,123,52,23,10,2,0,0,0,0,1,0,0,0,0,9,0,7
2772,164,529,204,325,7,318,2,316,91,106,52,28,20,8,2,0,0,1,0,0,0,0,2,0,0,0,6
2773,164,496,174,322,4,318,3,315,92,92,76,26,12,4,1,0,0,0,0,1,0,0,1,2,6,0,2
2774,164,658,241,417,2,415,1,414,98,142,90,42,14,9,1,0,1,0,1,1,1,0,4,1,5,1,3
2775,164,686,181,505,8,497,7,490,114,142,136,50,25,7,2,0,0,0,2,0,0,2,0,0,7,0,3
2776,164,654,175,479,6,473,6,467,105,149,122,61,17,6,1,0,0,0,0,0,0,3,0,0,1,0,2
2777,165,971,367,604,2,602,6,596,236,110,104,87,22,12,0,0,0,0,0,1,0,1,0,2,10,2,9
2778,165,877,347,530,4,526,12,514,206,102,91,68,13,15,0,1,0,0,0,0,0,2,1,1,8,0,6
2779,165,684,156,528,0,528,4,524,282,98,36,58,12,12,0,0,0,0,0,0,0,1,0,0,5,0,20
2780,165,845,229,616,6,610,5,605,310,110,55,87,17,12,0,0,0,0,0,0,0,2,1,0,4,0,7
2781,165,634,273,361,1,360,2,358,84,106,97,34,18,3,0,0,0,0,1,1,0,0,0,0,10,0,4
2782,165,801,262,539,3,536,10,526,144,163,121,46,20,11,1,0,1,0,0,2,0,4,0,2,5,0,6
2783,165,848,266,582,7,575,4,571,155,173,136,60,18,12,1,1,0,0,1,1,0,0,1,0,8,0,4
2784,165,544,156,388,5,383,5,378,122,99,90,36,15,4,0,1,0,0,1,0,2,0,1,1,6,0,0
2785,165,481,110,371,2,369,3,366,110,111,79,38,14,8,0,0,0,0,0,0,0,0,2,0,1,0,3
2786,165,815,242,573,3,570,9,561,150,171,131,64,25,11,0,2,0,0,0,0,0,0,0,0,4,0,3
2787,165,816,246,570,4,566,6,560,162,149,127,69,15,15,0,4,0,0,1,3,0,0,1,1,9,0,4
2788,165,673,203,470,6,464,6,458,145,124,104,46,14,7,0,1,1,0,0,0,0,2,0,0,8,1,5
2789,165,597,169,428,7,421,5,416,138,90,94,47,17,8,2,1,0,0,0,0,0,0,1,1,5,1,11
2790,165,559,138,421,2,419,5,414,158,65,105,40,17,11,0,0,0,0,0,2,0,1,0,1,5,0,9
2791,165,675,190,485,3,482,5,477,168,137,88,45,12,9,0,0,0,0,3,1,0,0,1,0,5,0,8
2792,165,601,216,385,2,383,4,379,141,95,84,35,9,8,1,0,0,0,0,0,0,0,0,2,1,0,3
2793,165,659,250,409,3,406,1,405,112,119,109,35,7,15,0,0,0,0,0,0,1,0,0,2,3,1,1
2794,166,663,139,524,0,524,4,520,358,35,10,97,0,2,0,0,0,0,0,1,0,0,0,1,0,0,16
2795,166,667,170,497,0,497,6,491,351,32,6,82,3,4,0,0,0,0,0,1,0,0,0,0,0,0,12
2796,166,980,236,744,6,738,11,727,269,171,137,93,14,17,0,2,0,0,0,0,0,2,0,1,8,1,12
2797,166,859,192,667,4,663,18,645,249,175,85,91,16,13,0,0,0,0,2,1,0,0,0,1,3,0,9
2798,166,523,128,395,4,391,2,389,140,93,75,49,17,9,0,0,0,0,0,0,0,1,0,0,2,0,3
2799,166,559,150,409,3,406,3,403,146,91,64,70,12,5,0,0,0,0,0,0,0,1,0,0,3,0,11
2800,166,661,160,501,3,498,6,492,171,137,78,64,15,10,1,0,0,0,0,0,0,1,0,1,6,0,8
2801,166,741,174,567,6,561,4,557,186,161,77,85,18,12,0,2,0,0,0,2,2,0,0,2,4,0,6
2802,166,624,271,353,0,353,6,347,155,62,40,59,9,7,0,0,0,0,1,0,0,0,1,0,5,1,7
2803,166,601,280,321,1,320,3,317,129,56,40,69,7,9,1,0,0,0,0,0,0,0,0,0,2,0,4
2804,166,696,199,497,3,494,3,491,191,113,67,74,13,20,0,0,0,0,0,2,0,1,0,0,3,2,5
2805,166,684,196,488,3,485,9,476,169,106,83,72,19,10,0,0,0,0,1,0,0,0,0,1,5,1,9
2806,166,636,161,475,1,474,5,469,202,82,46,108,14,10,0,0,0,0,0,0,0,0,0,0,1,0,6
2807,166,720,171,549,1,548,10,538,209,106,56,135,10,9,0,0,0,0,0,0,0,0,0,0,3,1,9
2808,166,666,167,499,1,498,10,488,214,87,45,107,7,10,0,0,0,0,0,0,1,1,1,1,4,0,10
2809,166,861,344,517,7,510,10,500,120,130,136,74,18,6,0,1,0,0,1,2,0,0,1,2,4,1,4
2810,166,799,307,492,5,487,4,483,90,124,137,74,25,6,0,0,0,0,2,1,0,2,1,0,8,2,11
2811,166,720,143,577,4,573,7,566,174,95,107,141,16,9,0,0,0,0,0,1,0,0,1,1,8,1,12
2812,166,760,160,600,0,600,8,592,196,111,81,137,18,14,0,2,0,0,0,2,0,1,0,2,5,1,22
2813,166,922,207,715,4,711,11,700,303,138,52,154,19,14,1,0,0,0,0,1,0,0,1,2,1,1,13
2814,166,956,248,708,4,704,11,693,268,141,72,138,20,26,1,0,0,1,0,0,1,0,0,0,2,2,21
2815,166,956,246,710,6,704,11,693,232,162,116,132,17,8,0,0,0,0,0,2,0,0,0,0,5,0,19
2816,166,866,277,589,8,581,8,573,293,72,29,153,7,7,0,0,0,0,0,0,0,0,0,0,1,0,11
2817,166,787,238,549,4,545,8,537,243,72,39,147,7,13,0,1,0,0,0,0,0,0,0,0,1,0,14
2818,166,1006,282,724,3,721,9,712,330,131,45,159,12,14,0,0,0,0,0,0,0,0,1,0,6,2,12
2819,166,953,293,660,2,658,12,646,193,130,110,152,26,14,0,0,0,0,0,0,0,0,0,1,11,0,9
2820,166,771,190,581,7,574,4,570,190,113,64,154,15,20,0,0,0,1,0,0,0,2,0,0,3,2,6
2821,166,810,169,641,8,633,8,625,250,121,77,133,15,16,0,0,0,0,0,0,0,1,0,0,2,1,9
2822,166,795,179,616,4,612,9,603,186,101,117,137,20,23,2,0,1,0,1,1,0,0,0,1,6,0,7
2823,166,731,163,568,5,563,9,554,202,89,91,133,15,13,0,1,0,0,0,1,0,0,0,2,7,0,0
2824,166,964,272,692,4,688,2,686,258,149,67,173,6,20,0,0,0,0,1,1,0,0,0,0,2,1,8
2825,166,641,160,481,5,476,9,467,129,126,65,81,32,21,0,0,0,0,0,0,0,0,1,0,2,0,10
2826,166,581,149,432,6,426,6,420,94,101,89,83,26,14,0,1,0,0,0,0,0,1,0,1,3,0,7
2827,166,983,222,761,6,755,10,745,363,119,55,162,11,14,2,0,0,0,1,0,0,0,0,1,4,1,12
2828,166,850,179,671,2,669,2,667,452,49,13,125,5,8,0,0,0,0,0,0,0,0,0,0,0,0,15
2829,166,867,197,670,6,664,1,663,256,94,72,186,17,23,0,0,0,0,0,0,0,1,0,1,7,0,6
2830,166,928,231,697,12,685,6,679,266,96,82,171,12,21,0,1,0,1,1,0,0,0,0,1,7,3,17
2831,166,529,138,391,5,386,6,380,208,49,21,80,3,3,0,0,0,0,0,0,0,0,0,0,3,0,13
2832,166,589,151,438,2,436,5,431,209,76,22,98,3,8,0,1,0,0,1,0,0,0,0,0,4,0,9
2833,171,935,344,591,5,586,7,579,126,236,111,43,42,12,2,1,0,0,0,1,0,0,1,0,1,0,3
2834,171,848,294,554,10,544,4,540,157,166,118,54,21,10,1,0,0,0,1,0,0,1,1,3,3,0,4
2835,171,677,274,403,4,399,4,395,76,158,94,21,30,4,1,0,0,0,0,1,0,0,1,0,8,0,1
2836,171,711,296,415,4,411,2,409,92,163,98,20,20,5,1,0,0,0,0,1,0,0,2,2,4,1,0
2837,171,555,209,346,4,342,2,340,53,139,72,29,28,8,0,0,0,0,0,1,0,1,0,1,7,1,0
2838,171,541,227,314,5,309,5,304,82,94,71,28,9,3,0,0,0,2,0,0,0,3,0,1,7,0,4
2839,171,604,246,358,0,358,2,356,81,133,74,18,35,3,1,0,0,0,0,0,2,0,0,0,8,1,0
2840,171,964,390,574,0,574,1,573,126,215,117,45,40,9,0,0,2,0,0,0,1,1,2,0,11,1,3
2841,171,617,241,376,6,370,4,366,73,137,67,37,19,19,4,0,0,0,0,0,0,0,0,0,4,1,5
2842,171,814,295,519,4,515,7,508,146,178,107,28,19,14,0,0,0,0,0,0,1,0,1,0,8,3,3
2843,171,809,294,515,5,510,2,508,161,165,84,44,24,7,0,0,0,0,0,0,1,0,2,4,8,1,7
2844,171,523,191,332,0,332,2,330,106,114,60,25,14,5,0,0,0,0,1,1,0,0,0,0,3,0,1
2845,171,530,184,346,0,346,2,344,112,119,54,35,10,5,0,0,0,0,0,1,0,1,2,0,2,1,2
2846,171,592,203,389,2,387,3,384,107,138,76,21,22,13,0,0,0,1,0,0,1,0,0,0,4,1,0
2847,171,740,325,415,9,406,6,400,84,143,90,35,26,8,1,0,0,0,0,0,0,0,1,1,9,2,0
2848,171,856,342,514,4,510,3,507,102,220,102,37,30,3,0,0,0,0,1,1,0,0,0,2,7,0,2
2849,171,648,239,409,4,405,2,403,79,173,89,16,35,5,0,0,0,0,0,0,0,0,1,0,4,0,1
2850,171,878,293,585,4,581,7,574,142,202,112,44,40,8,4,0,1,0,0,2,1,0,0,0,12,0,6
2851,171,669,289,380,4,376,2,374,77,139,102,16,19,10,0,0,0,0,0,0,1,0,1,2,3,0,4
2852,171,572,200,372,5,367,3,364,91,140,69,24,26,3,0,0,0,0,0,0,0,3,0,3,3,0,2
2853,171,657,229,428,3,425,4,421,61,174,122,27,23,11,1,0,0,0,0,0,0,0,0,0,1,0,1
2854,171,920,516,404,3,401,4,397,58,155,134,18,20,6,0,0,0,0,1,0,0,0,0,0,2,1,2
2855,171,778,349,429,5,424,7,417,84,156,109,31,21,1,0,0,0,0,0,0,1,0,0,3,6,2,3
2856,171,687,206,481,7,474,2,472,128,164,84,43,31,8,1,0,0,1,0,0,0,0,0,3,7,0,2
2857,171,748,249,499,4,495,1,494,124,151,121,37,43,4,0,2,0,0,0,0,2,0,1,2,5,1,1
2858,171,605,231,374,4,370,2,368,98,117,88,31,17,5,2,0,0,0,0,0,0,0,0,0,8,0,2
2859,171,573,237,336,6,330,0,330,86,127,62,25,21,4,0,0,0,0,0,0,0,0,0,0,5,0,0
2860,171,559,199,360,3,357,2,355,88,152,64,25,11,5,0,0,2,0,0,0,0,0,1,2,5,0,0
2861,171,892,358,534,2,532,3,529,100,227,103,41,39,15,0,0,0,0,1,0,0,0,0,0,1,0,2
2862,171,687,212,475,4,471,11,460,89,156,121,44,29,14,2,0,0,0,0,0,0,0,1,2,1,1,0
2863,171,752,250,502,7,495,5,490,100,169,112,59,26,10,0,0,0,0,0,1,0,0,0,3,6,2,2
2864,171,796,284,512,10,502,9,493,129,188,89,52,17,9,2,0,0,0,0,0,0,1,0,0,5,1,0
2865,171,1008,319,689,5,684,9,675,152,186,168,93,39,16,1,0,1,1,0,0,0,1,3,0,10,0,4
2866,171,947,523,424,4,420,3,417,54,183,112,29,29,2,0,1,0,0,0,1,0,0,0,0,4,1,1
2867,171,691,191,500,0,500,7,493,68,135,166,42,67,3,1,0,0,1,0,0,2,0,1,0,6,0,1
2868,171,684,306,378,4,374,4,370,96,135,79,21,25,6,0,0,0,0,1,0,1,0,1,0,3,0,2
2869,171,939,278,661,0,661,0,661,135,175,191,83,39,17,1,0,2,1,0,3,0,1,0,0,7,0,6
2870,171,886,281,605,3,602,6,596,109,156,166,76,44,18,0,0,0,2,0,1,1,0,2,7,10,3,1
2871,171,858,301,557,1,556,5,551,89,206,168,47,22,8,0,1,0,0,1,0,1,1,2,0,3,0,2
2872,171,669,133,536,7,529,6,523,105,167,120,81,30,10,0,0,0,0,0,1,0,0,0,0,5,0,4
2873,171,635,149,486,1,485,5,480,100,147,102,74,26,15,0,0,1,0,0,0,0,1,0,1,8,2,3
2874,172,691,345,346,3,343,4,339,74,123,83,17,27,5,0,0,0,0,0,0,0,0,1,0,7,1,1
2875,172,541,272,269,4,265,3,262,55,106,64,15,11,0,0,0,0,0,0,0,0,1,1,0,5,3,1
2876,172,561,283,278,1,277,2,275,69,104,55,13,23,1,0,0,0,0,0,1,0,0,1,3,4,0,1
2877,172,709,353,356,6,350,10,340,81,128,78,22,17,5,2,0,0,0,0,1,2,0,1,0,1,1,1
2878,172,717,374,343,1,342,1,341,56,124,86,13,39,2,4,0,0,0,0,2,0,3,0,2,6,2,2
2879,172,561,239,322,3,319,4,315,63,117,87,12,26,2,0,1,0,0,1,1,0,0,0,0,2,1,2
2880,172,625,357,268,2,266,2,264,46,106,81,9,12,2,0,0,0,0,0,0,0,0,0,2,0,3,3
2881,172,813,345,468,2,466,7,459,102,120,154,20,26,6,1,1,0,0,0,3,1,3,2,4,7,5,4
2882,172,557,296,261,1,260,5,255,69,81,73,16,6,3,0,0,0,0,0,0,0,1,0,0,2,2,2
2883,172,570,298,272,0,272,2,270,48,100,78,14,16,4,2,1,0,3,0,0,0,0,1,0,1,0,2
2884,172,639,358,281,1,280,1,279,58,93,87,17,13,2,0,1,0,0,0,0,3,0,1,1,2,0,1
2885,172,785,387,398,2,396,4,392,77,161,105,14,20,4,0,1,0,0,0,1,1,0,0,1,5,2,0
2886,172,533,233,300,1,299,4,295,52,126,64,17,22,5,2,0,0,0,0,3,0,2,0,1,1,0,0
2887,172,565,276,289,4,285,0,285,63,114,73,18,11,3,0,0,0,0,0,0,0,0,0,1,1,0,1
2888,173,924,279,645,8,637,5,632,113,172,147,110,40,26,1,0,0,0,1,1,1,1,0,1,10,2,6
2889,173,963,249,714,12,702,12,690,141,183,170,112,44,20,1,0,0,1,0,0,0,0,0,2,8,0,8
2890,173,581,222,359,5,354,3,351,83,114,80,37,21,6,0,1,1,0,0,0,0,0,0,0,5,0,3
2891,173,573,225,348,4,344,1,343,66,145,68,28,23,5,1,0,0,1,0,0,0,0,0,3,2,0,1
2892,173,526,224,302,2,300,1,299,74,106,75,20,18,2,0,0,0,0,0,0,0,0,0,0,3,0,1
2893,173,502,224,278,6,272,3,269,59,86,66,24,25,2,0,1,0,0,0,0,0,0,0,0,5,1,0
2894,173,566,198,368,5,363,2,361,61,125,112,26,19,1,1,1,0,0,1,1,0,0,0,2,6,0,5
2895,173,610,203,407,2,405,2,403,61,136,130,27,27,12,2,0,0,0,0,0,0,1,0,2,3,1,1
2896,173,777,196,581,11,570,6,564,82,166,167,75,39,15,0,2,0,1,0,0,0,0,0,2,11,2,2
2897,173,823,196,627,9,618,10,608,101,178,160,91,49,16,0,0,0,0,0,1,0,2,0,1,4,1,4
2898,173,680,166,514,5,509,9,500,87,145,137,89,22,11,0,0,0,0,0,0,0,0,0,2,6,1,0
2899,173,650,159,491,6,485,4,481,91,135,117,82,33,10,2,0,0,0,0,0,0,0,1,1,6,1,2
2900,173,704,253,451,5,446,6,440,55,112,146,74,29,9,1,3,0,0,0,0,0,2,2,2,3,0,2
2901,173,695,231,464,4,460,4,456,62,121,145,77,24,11,1,0,1,0,1,1,0,3,0,0,6,1,2
2902,173,504,116,388,4,384,1,383,57,114,95,65,25,11,3,0,0,0,0,0,0,0,0,1,7,5,0
2903,173,532,120,412,5,407,6,401,74,110,95,77,32,5,0,0,0,1,0,0,0,0,0,1,5,1,0
2904,174,701,238,463,1,462,3,459,79,173,104,50,34,6,0,0,0,0,0,1,0,0,0,1,5,0,6
2905,174,675,189,486,3,483,5,478,72,170,121,49,42,13,0,0,0,0,0,1,0,0,1,2,3,1,3
2906,174,706,366,340,1,339,8,331,68,120,88,30,16,3,0,0,0,0,1,0,0,0,0,0,5,0,0
2907,174,937,376,561,11,550,2,548,127,214,111,37,36,5,2,0,0,0,2,2,0,1,0,3,6,1,1
2908,174,684,314,370,2,368,0,368,85,137,87,17,19,10,0,0,0,0,1,2,0,0,1,2,2,3,2
2909,174,799,290,509,4,505,3,502,137,194,106,31,13,12,1,0,0,1,0,0,0,0,0,2,3,0,2
2910,174,690,195,495,7,488,4,484,164,161,90,30,19,9,0,0,0,0,0,0,0,0,3,1,3,2,2
2911,174,760,353,407,5,402,2,400,120,141,67,31,20,10,0,0,0,0,0,0,0,0,0,1,7,0,3
2912,174,618,206,412,4,408,1,407,103,144,85,25,23,14,0,0,0,0,0,2,0,0,2,0,7,0,2
2913,174,624,208,416,2,414,2,412,120,132,84,44,19,9,0,0,0,0,1,0,0,0,0,1,1,0,1
2914,174,963,396,567,16,551,4,547,104,218,100,45,52,10,1,1,0,0,0,2,0,1,1,1,8,3,0
2915,174,867,341,526,2,524,4,520,111,160,131,51,38,6,1,1,1,0,0,2,0,2,1,1,8,2,4
2916,174,926,324,602,15,587,5,582,145,193,132,53,30,11,1,0,3,0,0,1,2,3,0,0,5,2,1
2917,174,659,241,418,3,415,3,412,76,158,94,29,21,15,0,0,0,0,0,1,0,1,0,2,14,0,1
2918,174,761,405,356,2,354,2,352,73,146,93,17,19,3,0,0,1,0,0,0,0,0,0,0,0,0,0
2919,174,897,391,506,4,502,1,501,112,199,112,30,31,7,0,1,0,0,0,1,0,1,1,2,4,0,0
2920,174,661,266,395,0,395,1,394,101,156,68,34,18,10,0,0,0,0,0,0,1,0,0,0,4,0,2
2921,174,899,371,528,4,524,3,521,139,184,115,31,28,13,0,0,0,0,0,1,0,1,2,1,3,0,3
2922,174,779,318,461,2,459,0,459,120,171,92,25,35,3,1,1,0,0,0,0,2,0,0,3,4,2,0
2923,174,689,308,381,7,374,8,366,85,152,61,20,32,8,1,0,0,0,0,0,0,0,0,2,3,0,2
2924,174,923,229,694,7,687,7,680,136,213,173,83,35,14,0,1,0,3,0,0,0,2,1,1,9,4,5
2925,174,979,245,734,11,723,7,716,141,221,176,93,51,17,0,0,0,1,0,0,0,3,0,0,7,1,5
2926,174,680,160,520,4,516,2,514,121,152,119,65,32,11,0,0,0,0,0,2,1,0,1,1,3,1,5
2927,174,632,166,466,5,461,5,456,119,142,96,57,24,11,0,0,0,0,0,1,0,0,1,1,2,0,2
2928,174,833,227,606,5,601,14,587,89,198,152,81,36,20,1,0,0,2,0,1,0,0,0,1,5,0,1
2929,174,769,228,541,6,535,8,527,111,162,126,68,31,15,0,0,0,2,0,0,0,0,1,0,5,0,6
2930,174,744,224,520,5,515,4,511,92,167,143,58,30,7,0,0,0,0,1,0,1,1,2,2,3,1,3
2931,174,745,238,507,6,501,3,498,111,135,127,74,35,9,0,0,0,0,0,0,0,0,1,1,2,2,1
2932,174,592,153,439,6,433,6,427,98,139,96,49,19,15,0,1,0,0,0,1,2,0,1,1,3,0,2
2933,174,524,140,384,2,382,1,381,75,118,100,47,28,4,0,0,0,1,0,0,1,2,0,1,2,1,1
2934,174,543,138,405,6,399,3,396,92,115,79,68,25,13,0,0,0,0,0,1,0,0,0,0,2,0,1
2935,174,510,131,379,4,375,2,373,69,116,78,65,26,8,0,0,1,0,0,0,1,0,0,0,5,1,3
2936,174,588,150,438,3,435,4,431,94,120,93,86,18,15,0,0,0,0,0,0,2,0,0,1,2,0,0
2937,174,629,177,452,4,448,8,440,89,121,100,84,24,10,0,1,0,0,0,0,0,0,0,2,4,0,5
2938,175,577,269,308,2,306,1,305,49,99,88,31,19,3,2,0,1,0,0,1,0,1,1,0,7,1,2
2939,175,622,274,348,1,347,1,346,42,115,115,33,29,1,0,0,0,1,0,0,0,1,1,2,3,1,2
2940,175,967,385,582,8,574,3,571,126,228,119,45,33,8,2,0,0,1,0,0,0,0,0,1,6,0,2
2941,175,593,153,440,7,433,7,426,125,141,75,46,25,6,0,0,0,0,0,0,0,1,0,1,5,0,1
2942,175,579,151,428,4,424,6,418,105,158,70,35,30,12,1,0,0,0,0,0,0,0,0,1,5,0,1
2943,175,705,203,502,4,498,6,492,143,170,101,33,22,9,0,0,0,0,0,0,2,1,0,0,6,0,5
2944,175,770,249,521,2,519,4,515,167,179,84,53,15,4,0,0,0,1,0,1,0,1,1,0,6,0,3
2945,175,672,296,376,3,373,3,370,91,121,94,29,17,7,1,0,2,0,0,0,0,1,0,0,5,0,2
2946,175,708,239,469,6,463,3,460,123,170,93,28,23,11,0,3,1,1,0,0,0,1,0,0,5,1,0
2947,175,646,170,476,4,472,7,465,160,151,69,47,18,9,1,0,0,0,0,0,0,2,0,0,4,2,2
2948,175,593,193,400,4,396,0,396,110,148,77,34,14,4,0,0,0,0,1,0,0,0,0,0,1,0,7
2949,175,553,172,381,4,377,1,376,115,137,71,29,12,8,0,0,0,0,0,0,0,1,0,0,2,0,1
2950,175,964,248,716,4,712,5,707,271,206,119,51,34,17,0,0,0,0,0,0,0,1,0,1,5,0,2
2951,175,526,131,395,3,392,2,390,149,120,51,31,18,8,0,0,0,0,0,1,0,0,0,0,6,0,6
2952,175,568,141,427,6,421,3,418,168,140,61,26,14,2,0,0,0,0,0,0,0,0,1,0,0,0,6
2953,175,621,192,429,3,426,3,423,117,162,95,25,11,5,0,1,0,0,0,0,0,0,0,2,3,0,2
2954,175,642,141,501,6,495,3,492,140,144,115,49,27,9,0,0,1,1,0,0,1,0,0,0,4,0,1
2955,175,652,155,497,1,496,8,488,127,139,117,59,27,14,1,0,0,0,0,0,0,0,0,1,1,1,1
2956,175,555,180,375,8,367,1,366,108,118,78,37,12,4,0,0,0,0,0,0,0,0,0,0,7,0,2
2957,175,567,203,364,2,362,3,359,115,117,73,22,16,4,1,0,0,0,0,0,0,3,1,0,3,0,4
2958,175,968,349,619,8,611,4,607,145,207,134,45,33,21,0,0,0,1,1,0,0,1,0,7,10,0,2
2959,175,726,271,455,6,449,6,443,108,152,108,35,26,3,1,1,0,0,1,0,0,0,0,0,8,0,0
2960,175,603,174,429,3,426,1,425,190,104,69,27,14,8,0,0,0,0,0,0,0,0,1,0,3,0,9
2961,175,599,169,430,7,423,3,420,175,125,50,32,13,9,0,0,0,0,1,4,0,0,1,0,4,0,6
2962,175,641,183,458,0,458,1,457,162,152,73,33,15,9,2,0,0,0,0,0,0,0,0,0,5,0,6
2963,175,545,178,367,1,366,4,362,130,104,66,33,13,6,0,0,0,0,1,0,0,0,0,0,3,1,5
2964,175,882,302,580,5,575,5,570,177,181,122,40,19,14,5,0,0,0,0,0,0,0,1,0,6,0,5
2965,175,823,295,528,5,523,10,513,178,138,89,44,32,15,1,0,0,1,0,1,0,0,1,2,6,2,3
2966,175,801,323,478,6,472,3,469,146,148,91,45,21,2,3,0,1,0,0,1,0,0,0,0,10,0,1
2967,175,679,155,524,2,522,5,517,179,139,104,55,24,7,0,0,0,0,0,0,0,2,0,0,2,0,5
2968,175,580,140,440,4,436,6,430,120,114,99,37,41,6,1,0,1,1,0,2,0,0,1,1,3,2,1
2969,175,616,201,415,6,409,4,405,123,124,81,33,20,11,0,0,1,0,0,0,0,0,1,0,4,1,6
2970,175,635,195,440,4,436,1,435,143,141,84,33,17,6,0,0,0,0,0,2,0,0,0,1,4,1,3
2971,175,522,119,403,1,402,0,402,109,116,81,56,22,9,0,0,0,0,0,1,1,0,2,0,3,0,2
2972,175,554,133,421,3,418,2,416,122,118,83,43,31,9,0,1,1,1,0,0,0,0,0,1,3,2,1
2973,181,981,351,630,1,629,1,628,107,219,191,50,25,11,2,0,0,1,1,2,0,0,0,0,18,0,1
2974,181,634,222,412,5,407,1,406,84,137,110,36,28,4,1,0,0,0,0,0,0,2,0,1,2,0,1
2975,181,846,301,545,0,545,3,542,124,145,170,45,32,10,0,0,0,0,0,0,0,0,1,2,10,2,1
2976,181,801,343,458,3,455,7,448,91,152,124,43,22,4,0,0,0,0,1,0,0,0,0,0,7,0,4
2977,181,777,308,469,4,465,5,460,104,153,129,38,25,2,1,0,0,0,0,0,0,1,0,1,4,0,2
2978,181,660,206,454,3,451,2,449,109,142,122,37,24,5,3,0,0,0,0,0,0,1,0,0,6,0,0
2979,181,853,267,586,8,578,2,576,116,202,153,46,37,9,0,0,0,1,0,0,0,1,1,2,5,0,3
2980,181,559,205,354,5,349,2,347,81,109,96,23,19,9,2,1,0,0,1,0,0,0,2,1,0,1,2
2981,181,566,207,359,4,355,3,352,64,129,98,25,19,6,1,1,0,0,0,1,2,1,0,0,4,0,1
2982,181,736,335,401,6,395,0,395,74,164,99,23,16,6,0,0,0,2,0,2,0,1,1,3,4,0,0
2983,181,868,281,587,7,580,3,577,125,189,145,57,31,10,0,0,0,2,0,1,0,0,0,1,10,2,4
2984,181,607,193,414,2,412,3,409,86,138,115,32,18,7,0,0,2,0,0,0,0,0,1,1,6,0,3
2985,181,571,216,355,0,355,2,353,61,124,103,30,20,3,0,0,0,0,0,1,0,2,0,1,7,0,1
2986,181,849,281,568,3,565,8,557,115,187,171,29,31,10,3,0,0,0,0,1,0,3,0,1,3,2,1
2987,181,933,335,598,10,588,3,585,154,183,146,45,24,9,0,0,0,0,0,5,2,1,0,2,8,3,3
2988,181,738,300,438,1,437,1,436,101,139,131,35,21,2,0,1,0,0,0,0,0,1,1,0,3,1,0
2989,181,880,330,550,6,544,4,540,101,182,175,28,30,8,0,0,0,0,1,0,0,1,1,1,11,1,0
2990,181,825,340,485,0,485,7,478,76,175,137,26,43,6,6,0,0,0,0,0,0,1,0,0,5,2,1
2991,181,621,202,419,5,414,1,413,87,125,123,38,28,4,1,0,0,0,0,0,0,2,0,0,2,0,3
2992,181,666,226,440,5,435,4,431,87,136,105,44,30,12,0,0,0,0,0,3,1,0,1,1,8,1,2
2993,181,618,213,405,2,403,3,400,71,140,117,34,25,4,2,0,0,0,0,0,0,2,0,1,3,1,0
2994,181,654,238,416,0,416,1,415,68,164,106,36,19,15,2,0,0,0,0,0,0,0,0,1,4,0,0
2995,181,568,106,462,2,460,6,454,104,134,121,40,33,12,0,0,0,0,0,1,0,1,0,0,5,1,2
2996,181,596,146,450,1,449,5,444,111,141,105,41,30,8,0,0,0,0,0,0,0,1,2,0,1,0,4
2997,181,873,199,674,2,672,8,664,137,218,203,43,37,11,2,0,0,0,0,0,0,0,0,1,8,1,3
2998,181,1007,339,668,14,654,4,650,120,238,178,47,45,10,1,0,0,0,0,0,0,1,0,0,6,0,4
2999,181,597,228,369,6,363,5,358,59,136,95,24,26,10,1,0,0,0,1,0,0,1,0,0,3,1,1
3000,181,797,228,569,8,561,6,555,117,196,146,39,36,6,0,0,0,1,0,0,1,2,1,2,6,1,1
3001,181,668,154,514,3,511,6,505,84,149,154,67,32,7,1,0,0,0,0,0,0,0,0,2,3,0,6
3002,181,620,127,493,5,488,2,486,81,139,129,72,32,17,1,0,1,1,0,0,0,0,0,3,5,1,4
3003,181,702,267,435,4,431,9,422,57,127,148,22,42,12,1,0,0,0,0,0,0,0,1,3,8,1,0
3004,181,711,271,440,2,438,9,429,42,164,127,41,32,8,1,0,0,0,1,0,0,0,0,1,11,0,1
3005,181,720,233,487,0,487,11,476,83,130,160,44,29,13,2,1,0,0,0,1,0,0,1,0,8,2,2
3006,181,716,234,482,5,477,4,473,70,156,145,47,33,12,0,0,0,0,0,0,0,1,0,0,7,1,1
3007,181,674,616,58,1,57,0,57,8,21,18,4,1,0,0,0,0,0,0,0,0,0,2,0,3,0,0
3008,181,650,609,41,0,41,2,39,4,10,19,1,0,0,0,0,0,1,0,0,0,0,1,0,2,0,1
3009,181,558,203,355,3,352,1,351,48,104,121,37,26,7,0,1,1,0,0,0,0,0,0,0,4,2,0
3010,181,618,229,389,3,386,4,382,69,121,107,44,25,8,0,0,1,1,0,0,0,1,0,0,4,0,1
3011,181,852,327,525,4,521,5,516,64,143,166,78,37,10,1,1,1,1,0,0,0,1,0,0,9,1,3
3012,181,875,162,713,8,705,6,699,129,198,164,132,48,17,1,0,0,0,0,1,0,1,0,2,4,1,1
3013,181,879,180,699,3,696,10,686,116,177,190,120,50,14,2,0,1,0,0,0,1,3,1,1,7,0,3
3014,181,957,247,710,5,705,10,695,104,152,236,124,40,17,0,0,0,1,0,2,0,1,0,0,11,0,7
3015,181,615,155,460,2,458,2,456,91,132,111,66,27,18,0,0,0,0,0,3,0,0,0,0,7,0,1
3016,181,618,178,440,4,436,1,435,89,126,102,84,20,6,1,0,0,0,0,0,0,0,1,0,3,0,3
3017,181,892,305,587,7,580,5,575,92,161,142,107,32,18,2,0,0,1,0,1,0,3,0,0,12,1,3
3018,181,964,278,686,7,679,6,673,123,168,177,136,34,20,2,0,0,2,0,1,0,0,1,0,7,1,1
3019,181,622,159,463,6,457,3,454,74,105,133,80,40,12,0,0,0,0,0,1,0,0,1,0,5,1,2
3020,181,665,158,507,7,500,6,494,68,126,140,90,34,22,1,0,0,0,0,0,0,2,1,1,5,1,3
3021,181,739,177,562,7,555,2,553,101,162,111,119,28,16,0,0,0,0,0,1,0,1,0,1,7,4,2
3022,181,673,156,517,10,507,7,500,88,136,123,88,34,14,1,0,0,0,1,0,1,0,0,1,8,0,5
3023,181,898,248,650,6,644,11,633,137,144,166,113,39,18,1,1,1,0,0,0,0,1,0,0,4,1,7
3024,181,959,311,648,5,643,8,635,108,152,182,125,35,19,1,0,0,2,0,0,0,0,0,2,4,2,3
3025,181,989,272,717,9,708,8,700,112,163,266,93,35,19,0,0,0,0,0,0,0,1,0,2,4,1,4
3026,181,622,160,462,5,457,5,452,95,101,118,103,12,8,1,0,0,0,0,0,0,1,0,1,10,0,2
3027,181,659,180,479,2,477,8,469,122,86,123,99,18,11,3,0,0,0,0,0,0,0,0,1,4,0,2
3028,181,628,238,390,3,387,7,380,69,100,102,61,33,9,0,0,0,0,0,0,0,0,0,0,4,0,2
3029,181,602,234,368,2,366,3,363,74,98,87,58,30,8,0,0,0,0,0,0,0,0,0,0,5,1,2
3030,181,533,153,380,1,379,2,377,57,96,107,67,29,13,0,0,1,0,0,0,0,0,0,0,4,1,2
3031,181,581,160,421,2,419,6,413,49,101,143,65,25,19,0,0,0,0,0,1,0,0,2,0,4,1,3
3032,181,794,208,586,5,581,6,575,109,133,151,109,41,15,1,0,0,1,0,0,0,1,1,3,6,2,2
3033,181,783,197,586,7,579,2,577,94,130,164,117,43,18,1,0,0,0,0,0,0,1,0,0,8,0,1
3034,181,628,164,464,3,461,5,456,100,102,102,114,24,4,0,0,0,0,0,0,0,0,0,0,6,1,3
3035,181,632,154,478,1,477,3,474,129,100,95,110,10,13,0,0,0,0,0,0,0,1,0,0,12,0,4
3036,181,788,218,570,4,566,6,560,95,114,175,127,30,10,1,0,0,0,0,0,1,1,0,0,5,1,0
3037,181,837,203,634,4,630,9,621,100,130,184,142,34,22,0,0,1,0,0,1,0,0,0,0,6,0,1
3038,181,755,192,563,5,558,7,551,81,127,166,108,47,11,0,0,0,0,1,0,1,1,0,0,6,0,2
3039,181,804,191,613,7,606,6,600,92,148,199,105,34,11,0,0,0,0,0,0,0,0,1,1,3,1,5
3040,181,912,275,637,4,633,8,625,94,161,176,119,36,12,3,0,1,0,1,1,0,0,2,1,10,0,8
3041,181,951,293,658,5,653,9,644,113,166,192,105,38,13,0,1,0,0,0,1,2,0,0,0,7,1,5
3042,181,645,244,401,1,400,6,394,54,98,133,55,33,11,1,0,0,0,0,0,0,1,0,3,5,0,0
3043,181,592,270,322,4,318,3,315,39,71,114,46,17,11,1,0,0,0,0,1,0,0,0,1,10,1,3
3044,182,609,256,353,1,352,1,351,43,127,119,17,28,8,1,0,0,1,0,0,1,0,2,0,3,0,1
3045,182,677,304,373,2,371,3,368,39,142,117,27,24,8,0,0,2,0,0,1,0,0,1,0,6,0,1
3046,182,615,213,402,3,399,1,398,85,130,100,44,20,8,1,0,1,1,0,0,1,1,0,0,4,0,2
3047,182,675,212,463,1,462,4,458,94,142,122,53,24,6,3,0,0,1,0,0,1,0,0,2,7,1,2
3048,182,814,189,625,5,620,10,610,174,198,121,66,30,12,0,1,2,0,0,0,0,1,0,0,0,1,4
3049,182,835,216,619,3,616,4,612,149,199,132,84,27,4,0,0,1,0,0,0,0,1,0,0,7,1,7
3050,182,927,176,751,7,744,6,738,172,246,171,95,27,9,0,0,1,0,0,0,0,1,0,1,7,1,7
3051,182,631,161,470,3,467,4,463,181,132,83,40,16,7,0,0,0,1,0,0,0,0,0,1,1,0,1
3052,182,862,247,615,6,609,8,601,217,152,102,67,31,14,0,0,0,0,0,0,2,0,1,0,8,0,7
3053,182,551,136,415,3,412,9,403,146,112,72,46,10,4,0,0,0,0,0,0,0,2,1,1,6,0,3
3054,182,516,136,380,6,374,1,373,121,138,51,35,19,7,0,0,0,0,0,0,0,0,0,0,1,0,1
3055,182,1016,257,759,8,751,6,745,279,190,130,89,27,10,0,0,0,0,0,0,0,2,0,0,8,0,10
3056,182,539,150,389,1,388,10,378,110,116,76,44,17,10,0,0,0,0,0,0,0,0,0,0,3,1,1
3057,182,495,129,366,0,366,2,364,103,106,87,37,18,5,1,0,0,1,0,1,0,0,0,0,4,0,1
3058,182,709,196,513,9,504,6,498,164,152,92,57,7,15,0,1,0,0,0,0,0,0,1,1,4,1,3
3059,182,534,146,388,4,384,4,380,111,125,77,29,17,11,0,0,0,0,1,0,0,1,0,0,5,0,3
3060,182,552,177,375,7,368,7,361,107,110,65,39,18,7,1,0,0,0,0,0,0,0,0,1,11,0,2
3061,182,787,247,540,4,536,6,530,140,178,115,34,50,5,2,0,0,0,0,0,0,0,0,1,2,0,3
3062,182,778,325,453,6,447,5,442,69,170,121,44,16,4,2,1,0,0,0,2,0,1,3,0,9,0,0
3063,182,643,149,494,4,490,6,484,133,155,99,61,24,7,0,0,0,0,0,0,1,0,0,0,4,0,0
3064,182,561,121,440,5,435,4,431,103,152,88,53,21,5,0,0,1,0,0,0,0,0,1,0,6,0,1
3065,182,772,169,603,5,598,9,589,202,159,89,72,30,10,0,0,0,0,0,0,0,1,0,1,8,0,17
3066,182,783,179,604,2,602,5,597,196,163,96,93,27,6,1,0,0,1,0,1,0,0,0,0,5,0,8
3067,182,974,258,716,13,703,4,699,248,167,132,102,27,8,2,0,1,0,1,0,0,1,1,1,7,0,1
3068,182,586,125,461,3,458,6,452,117,124,114,61,22,5,2,0,0,0,0,1,0,0,0,0,6,0,0
3069,182,597,128,469,11,458,1,457,101,125,116,64,26,14,0,0,0,0,0,0,0,0,0,1,5,1,4
3070,182,563,119,444,1,443,4,439,122,132,98,55,16,8,1,0,0,0,0,0,0,0,0,1,4,1,1
3071,182,598,160,438,1,437,3,434,125,149,79,60,14,7,0,0,0,0,0,0,0,0,0,0,0,0,0
3072,191,1018,708,310,1,309,0,309,84,54,101,30,14,9,2,0,0,1,0,0,0,0,1,1,4,4,4
3073,191,662,210,452,2,450,6,444,112,161,82,48,20,15,0,0,0,0,0,0,0,2,0,0,3,0,1
3074,191,679,206,473,4,469,3,466,149,133,85,46,21,16,5,0,0,1,0,0,0,1,2,0,6,0,1
3075,191,668,211,457,7,450,6,444,133,155,81,21,28,8,1,1,0,1,0,1,1,3,0,0,9,0,1
3076,191,598,206,392,5,387,5,382,107,142,60,39,18,12,0,0,0,0,0,0,0,1,0,0,3,0,0
3077,191,941,395,546,5,541,0,541,123,191,98,50,42,20,0,1,0,0,0,0,1,3,0,3,5,1,3
3078,191,857,302,555,3,552,2,550,125,168,124,63,36,18,1,0,0,0,3,0,0,1,0,0,9,1,1
3079,191,875,299,576,6,570,7,563,137,206,117,54,25,12,2,0,1,1,0,2,0,1,0,0,3,1,1
3080,191,933,345,588,4,584,5,579,144,198,121,58,20,21,0,0,1,0,0,0,0,0,2,1,8,2,3
3081,191,488,167,321,6,315,4,311,71,131,54,35,7,5,2,0,0,0,0,0,0,0,1,1,3,1,0
3082,191,536,199,337,1,336,2,334,88,117,71,33,13,4,1,0,0,0,0,0,0,1,1,0,3,0,2
3083,191,950,298,652,5,647,8,639,168,214,120,64,35,12,1,1,0,3,0,0,1,3,2,0,8,3,4
3084,191,760,261,499,6,493,6,487,160,140,106,34,22,12,0,2,0,0,1,0,1,0,0,1,5,1,2
3085,191,783,156,627,5,622,12,610,143,172,140,85,38,18,1,1,0,0,0,0,0,0,1,0,5,2,4
3086,191,813,168,645,6,639,6,633,128,193,155,83,50,15,0,1,0,0,0,1,0,0,1,0,5,0,1
3087,191,618,108,510,8,502,12,490,79,147,121,63,58,10,0,0,0,1,0,2,0,1,2,0,3,0,3
3088,191,662,112,550,0,550,3,547,86,166,145,72,55,13,0,0,1,0,0,1,2,0,0,1,3,0,2
3089,191,611,116,495,6,489,3,486,83,158,138,67,22,12,0,0,0,1,0,0,0,0,0,0,3,0,2
3090,191,636,132,504,2,502,3,499,82,188,131,58,19,11,0,1,0,0,0,0,0,2,2,0,2,1,2
3091,191,821,163,658,5,653,3,650,111,210,200,57,36,17,1,0,0,2,0,0,1,1,1,0,3,0,10
3092,191,807,153,654,14,640,10,630,108,223,171,66,32,16,0,1,0,3,0,0,0,0,0,0,3,0,7
3093,191,796,165,631,1,630,10,620,119,214,137,83,34,16,0,0,0,0,0,0,0,1,1,1,9,0,5
3094,191,846,180,666,8,658,17,641,132,226,153,57,36,19,2,0,1,0,0,1,0,1,1,2,4,0,6
3095,191,692,273,419,8,411,0,411,68,142,121,52,10,12,0,0,0,0,0,0,0,1,0,0,2,0,3
3096,191,764,333,431,5,426,3,423,65,151,126,48,16,9,0,0,0,0,0,0,0,1,1,1,3,0,2
3097,191,550,195,355,7,348,2,346,84,97,97,38,22,2,0,0,1,0,0,0,0,0,0,1,3,0,1
3098,191,566,188,378,2,376,4,372,74,115,107,46,18,4,0,0,0,0,0,0,1,1,0,1,4,0,1
3099,191,736,160,576,6,570,13,557,115,144,118,137,18,17,0,1,0,0,0,1,1,0,0,0,2,1,2
3100,191,793,158,635,4,631,7,624,163,166,134,111,22,17,0,1,0,0,0,0,0,1,0,0,6,1,2
3101,191,984,212,772,10,762,15,747,171,191,153,163,38,22,0,0,0,0,0,0,1,1,1,0,5,0,1
3102,191,802,157,645,11,634,10,624,134,166,140,110,37,22,0,2,0,2,0,1,0,2,1,0,4,1,2
3103,191,732,168,564,1,563,9,554,120,154,126,96,33,16,1,0,0,0,0,0,0,0,0,0,7,1,0
3104,191,492,108,384,2,382,8,374,75,110,99,41,23,16,0,0,0,0,0,0,0,2,0,0,5,2,1
3105,191,518,97,421,4,417,9,408,85,121,98,47,38,11,0,0,0,0,0,0,0,1,0,0,4,0,3
3106,191,620,192,428,3,425,5,420,52,117,135,61,34,8,0,1,0,0,0,0,0,2,3,2,3,0,2
3107,191,575,153,422,0,422,4,418,69,135,120,47,29,7,1,0,1,0,1,0,1,1,1,0,2,1,2
3108,191,574,117,457,1,456,9,447,95,108,110,90,20,14,0,0,0,1,0,0,0,0,3,0,3,0,3
3109,191,579,113,466,4,462,3,459,90,128,90,107,19,13,0,0,0,0,0,0,0,0,1,0,3,2,6
3110,191,581,119,462,7,455,7,448,119,108,100,83,14,14,0,0,0,0,0,0,0,5,0,1,2,0,2
3111,191,567,116,451,5,446,7,439,102,115,85,94,23,12,1,0,0,0,0,0,0,0,0,0,5,0,2
3112,191,788,172,616,4,612,7,605,120,154,154,103,35,26,0,1,2,1,1,0,0,0,0,0,7,0,1
3113,191,797,178,619,2,617,7,610,128,149,145,105,42,24,4,0,0,0,1,0,1,0,1,0,3,1,6
3114,191,608,147,461,4,457,5,452,114,130,76,76,30,11,1,0,0,0,0,0,1,0,2,1,5,5,0
3115,191,651,165,486,2,484,6,478,86,136,118,86,30,15,0,0,0,0,0,0,0,0,0,0,3,0,4
3116,191,730,134,596,7,589,5,584,133,165,110,123,28,16,1,0,0,1,0,0,0,1,0,1,2,0,3
3117,191,768,163,605,2,603,5,598,129,160,132,122,23,17,1,0,0,1,0,0,0,1,0,1,9,1,1
3118,191,831,158,673,2,671,5,666,197,210,117,91,25,16,0,0,0,0,0,0,0,3,1,0,5,0,1
3119,191,573,132,441,4,437,8,429,94,123,91,78,24,10,0,0,0,1,0,0,0,2,0,0,1,1,4
3120,191,645,133,512,4,508,8,500,115,128,111,103,18,8,0,1,1,0,0,1,0,2,2,0,2,0,8
3121,192,603,260,343,2,341,3,338,63,111,90,33,16,11,3,0,0,0,0,0,0,1,1,3,4,1,1
3122,192,548,224,324,1,323,2,321,40,127,97,19,17,6,0,0,0,4,0,0,0,1,2,0,6,0,2
3123,192,785,263,522,4,518,3,515,128,183,93,62,19,7,1,0,0,0,2,3,0,1,0,0,10,1,5
3124,192,640,233,407,6,401,7,394,79,157,82,31,22,7,3,1,0,0,1,0,1,1,4,0,3,1,1
3125,192,917,351,566,7,559,8,551,166,190,101,42,27,7,1,0,0,1,3,0,0,1,0,1,8,0,3
3126,192,700,248,452,4,448,4,444,164,157,68,30,11,4,0,0,0,1,0,0,0,1,2,0,4,0,2
3127,192,827,259,568,7,561,4,557,149,232,99,36,20,7,0,2,0,0,0,0,0,0,0,1,8,2,1
3128,192,979,322,657,7,650,7,643,195,214,122,59,25,14,2,1,0,0,1,0,0,0,2,1,5,2,0
3129,192,854,334,520,13,507,4,503,113,217,93,30,24,13,0,2,0,0,0,0,1,4,1,1,2,1,1
3130,192,833,334,499,5,494,3,491,135,174,99,34,25,5,2,0,0,0,1,1,0,0,2,0,11,0,2
3131,192,613,238,375,5,370,4,366,87,140,82,30,16,6,0,0,0,0,0,0,0,0,0,3,2,0,0
3132,192,758,270,488,8,480,2,478,122,157,112,27,38,11,1,0,0,0,0,0,0,3,1,2,3,0,1
3133,192,696,278,418,5,413,10,403,123,129,78,38,16,7,1,0,0,0,0,0,0,1,0,2,4,1,3
3134,192,674,250,424,3,421,4,417,92,155,102,21,25,5,1,1,0,1,1,0,0,0,1,3,4,1,4
3135,192,986,434,552,5,547,4,543,123,199,131,30,31,9,0,0,0,0,0,0,0,1,1,4,13,1,0
3136,192,664,247,417,1,416,3,413,85,159,95,34,17,12,0,0,0,1,0,0,0,2,2,3,2,0,1
3137,192,702,242,460,5,455,8,447,70,159,100,69,26,9,2,0,1,0,0,2,2,0,0,0,4,0,3
3138,192,711,225,486,1,485,6,479,82,139,130,72,19,19,1,0,0,0,0,0,3,0,2,0,8,0,4
3139,201,744,295,449,9,440,2,438,132,138,86,40,29,5,0,0,0,0,0,2,0,1,0,0,1,1,3
3140,201,713,285,428,3,425,3,422,115,137,79,43,24,14,0,0,0,0,0,0,1,0,0,1,5,0,3
3141,201,554,157,397,5,392,4,388,136,92,52,68,19,9,0,0,0,0,0,0,0,1,0,2,3,1,5
3142,201,610,143,467,7,460,12,448,150,124,66,76,13,10,0,0,0,1,0,0,0,0,0,1,4,1,2
3143,201,821,292,529,6,523,10,513,147,162,98,52,27,11,0,0,0,2,0,1,0,0,1,1,8,0,3
3144,201,646,271,375,3,372,3,369,100,111,75,40,18,8,0,0,0,0,1,5,0,2,0,1,4,0,4
3145,201,557,205,352,8,344,0,344,89,114,71,25,28,5,0,0,0,0,0,1,0,0,0,1,6,2,2
3146,201,567,215,352,2,350,1,349,90,120,76,27,22,5,0,0,0,0,0,0,0,0,0,1,3,2,3
3147,201,910,348,562,4,558,10,548,97,162,171,41,44,10,0,1,0,0,1,2,0,0,0,0,10,6,3
3148,201,690,244,446,4,442,5,437,103,154,103,27,33,11,0,0,0,0,0,2,0,1,0,0,2,0,1
3149,201,590,199,391,2,389,3,386,91,126,101,23,27,8,0,0,0,0,0,0,0,0,0,1,3,2,4
3150,201,542,186,356,0,356,0,356,77,119,114,19,20,3,0,0,0,0,0,0,0,0,0,1,3,0,0
3151,201,898,405,493,7,486,9,477,110,154,123,35,27,10,0,0,0,0,0,3,1,2,1,4,5,0,2
3152,201,633,268,365,4,361,6,355,69,119,103,18,31,5,3,0,0,0,0,0,0,1,1,1,4,0,0
3153,201,551,226,325,3,322,1,321,80,109,75,21,19,3,0,0,0,0,1,0,0,3,1,3,3,0,3
3154,201,635,279,356,7,349,2,347,61,136,92,24,19,6,1,0,0,0,0,0,0,0,0,0,7,0,1
3155,201,552,231,321,0,321,6,315,67,120,67,27,19,3,0,0,0,0,0,0,0,0,0,0,9,0,3
3156,201,734,269,465,3,462,8,454,118,147,95,52,23,9,0,1,0,0,0,0,0,1,0,1,4,1,2
3157,201,643,241,402,3,399,1,398,88,146,88,29,25,7,0,0,1,0,0,0,0,2,0,2,5,1,4
3158,201,517,196,321,4,317,1,316,83,93,77,17,32,3,0,0,0,0,0,0,0,0,2,0,4,0,5
3159,201,603,250,353,4,349,2,347,60,120,93,32,30,3,2,0,0,0,0,0,0,0,0,1,5,1,0
3160,201,548,224,324,0,324,6,318,118,84,54,29,19,4,0,0,0,0,0,0,0,2,0,0,2,2,4
3161,201,523,230,293,1,292,2,290,101,74,64,24,18,3,0,1,0,1,0,0,0,0,0,1,1,0,2
3162,201,579,133,446,3,443,5,438,128,115,70,86,19,14,0,0,0,0,1,0,0,1,0,0,3,0,1
3163,201,601,143,458,2,456,5,451,138,107,70,104,12,11,1,1,0,1,0,0,0,1,0,0,4,0,1
3164,201,894,274,620,3,617,6,611,214,133,112,110,20,11,0,0,0,0,0,1,0,0,0,1,0,0,9
3165,201,971,293,678,8,670,5,665,208,141,124,129,27,23,1,1,0,0,0,0,0,0,0,0,3,1,7
3166,201,992,218,774,8,766,12,754,309,137,85,158,16,27,0,0,0,1,0,0,0,1,1,1,4,1,13
3167,202,629,232,397,5,392,3,389,89,122,116,26,18,5,3,0,0,1,0,0,0,1,0,0,6,2,0
3168,202,789,314,475,4,471,4,467,83,138,163,27,25,9,0,1,0,3,2,1,0,1,0,1,10,2,1
3169,202,712,247,465,2,463,6,457,88,150,122,33,30,15,2,0,0,0,0,0,0,1,3,1,8,0,4
3170,202,541,242,299,0,299,12,287,52,101,82,19,11,7,4,0,0,1,0,2,0,0,0,0,7,0,1
3171,202,751,282,469,14,455,4,451,97,153,132,25,20,8,0,0,0,0,1,1,1,0,3,3,5,1,1
3172,202,565,191,374,6,368,0,368,90,122,82,29,21,9,0,0,0,0,0,0,1,1,1,4,6,0,2
3173,202,486,161,325,3,322,2,320,99,99,76,23,12,5,1,1,0,0,0,0,0,0,0,1,2,0,1
3174,202,918,315,603,7,596,5,591,154,190,152,39,29,9,1,2,0,0,1,1,0,0,2,1,6,1,3
3175,202,656,227,429,5,424,5,419,119,152,93,24,19,5,0,1,0,0,0,0,0,0,1,2,3,0,0
3176,202,509,178,331,3,328,3,325,70,105,84,38,9,6,0,1,0,0,0,0,0,0,0,0,9,1,2
3177,202,564,236,328,2,326,1,325,80,99,82,21,22,6,0,0,0,0,0,0,1,1,1,1,7,2,2
3178,203,822,382,440,2,438,1,437,99,149,97,40,35,5,3,1,0,0,0,0,0,0,1,1,4,1,1
3179,203,697,374,323,2,321,8,313,70,100,81,21,27,2,2,0,0,1,0,0,0,0,1,3,5,0,0
3180,203,707,330,377,1,376,7,369,69,139,92,21,28,10,0,0,0,0,0,0,0,0,0,0,7,0,3
3181,203,774,366,408,2,406,3,403,75,152,106,19,28,7,0,1,1,2,1,0,0,0,0,2,7,1,1
3182,203,766,354,412,3,409,1,408,76,160,109,25,14,5,2,0,0,0,0,1,1,2,3,0,5,1,4
3183,203,730,358,372,4,368,4,364,65,148,104,21,14,5,1,0,0,0,0,0,0,0,0,0,4,1,1
3184,203,644,235,409,7,402,2,400,105,119,103,30,21,17,1,0,0,0,0,0,0,0,0,1,3,0,0
3185,203,541,196,345,6,339,3,336,77,114,82,24,18,6,1,0,2,0,0,0,0,0,1,1,5,1,4
3186,203,582,194,388,5,383,3,380,120,115,83,24,22,5,1,1,1,0,0,1,0,1,0,1,4,0,1
3187,204,793,250,543,8,535,0,535,161,163,109,52,28,13,0,1,0,0,0,0,0,0,1,0,5,0,2
3188,204,772,261,511,3,508,3,505,98,198,99,37,46,12,0,0,0,0,0,0,0,2,2,1,9,0,1
3189,204,562,200,362,1,361,8,353,75,126,82,31,19,10,0,0,0,0,0,0,0,3,2,1,3,0,1
3190,204,697,241,456,2,454,2,452,96,156,118,22,31,10,0,1,2,0,0,0,0,1,2,5,3,1,4
3191,204,816,300,516,3,513,1,512,99,216,131,28,28,7,0,1,0,0,0,0,0,1,0,0,0,1,0
3192,204,670,283,387,7,380,2,378,71,147,77,25,35,10,1,1,0,0,0,0,0,0,1,1,9,0,0
3193,204,533,203,330,1,329,4,325,65,127,78,19,21,3,1,0,0,0,1,0,0,1,0,0,8,1,0
3194,204,538,220,318,1,317,1,316,49,116,103,21,11,6,1,0,0,1,0,0,0,1,0,0,7,0,0
3195,204,703,345,358,3,355,5,350,49,134,99,26,23,7,0,0,1,1,1,0,0,0,0,5,3,0,1
3196,204,789,321,468,5,463,7,456,87,147,124,48,31,6,0,0,0,0,0,0,0,0,1,1,7,1,3
3197,204,745,288,457,2,455,5,450,90,151,140,18,31,3,0,0,1,1,2,2,0,0,1,2,8,0,0
3198,204,749,315,434,4,430,6,424,96,156,90,37,21,9,1,0,0,0,0,1,0,0,1,1,6,5,0
3199,204,760,339,421,1,420,4,416,94,127,120,28,28,10,0,0,0,0,0,0,0,1,0,2,5,0,1
3200,204,677,315,362,1,361,2,359,76,102,113,25,25,5,1,0,0,1,0,0,0,1,0,2,4,1,3
3201,204,569,107,462,1,461,7,454,159,101,74,71,26,17,0,0,0,0,1,0,0,0,0,1,2,0,2
3202,204,601,123,478,3,475,5,470,155,106,85,69,19,16,0,0,0,0,3,0,0,1,3,1,6,1,5
3203,204,502,165,337,4,333,0,333,64,115,73,34,25,12,1,0,0,0,0,0,1,0,1,1,5,0,1
3204,204,543,168,375,4,371,6,365,75,125,94,30,21,10,1,0,0,1,0,0,0,0,0,0,4,2,2
3205,204,818,331,487,8,479,2,477,123,175,95,30,33,9,0,0,0,0,0,2,0,0,3,0,4,2,1
3206,204,588,218,370,4,366,2,364,89,114,81,33,26,4,4,1,0,1,0,0,1,2,0,2,4,0,2
3207,204,741,269,472,2,470,4,466,92,129,138,50,26,21,1,1,1,1,0,0,0,0,0,1,4,1,0
3208,204,771,242,529,5,524,7,517,89,168,145,52,35,9,3,0,0,0,1,0,2,0,0,0,8,4,1
3209,204,616,134,482,5,477,10,467,96,123,86,84,43,21,0,1,0,0,1,0,0,1,0,1,6,1,3
3210,204,690,164,526,4,522,7,515,123,136,108,62,33,29,2,1,0,2,0,0,0,1,2,1,15,0,0
3211,204,705,194,511,9,502,7,495,163,114,80,97,17,17,0,0,0,0,1,1,1,0,1,0,2,0,1
3212,204,721,196,525,3,522,12,510,155,127,102,84,24,9,0,0,0,0,0,0,0,0,1,0,4,1,3
3213,205,611,165,446,9,437,4,433,142,134,85,42,13,9,0,0,0,1,0,0,0,0,0,0,3,1,3
3214,205,613,146,467,7,460,4,456,134,144,86,44,29,8,0,0,0,1,1,0,0,0,0,0,6,1,2
3215,205,504,103,401,5,396,3,393,98,140,96,27,26,3,0,0,0,0,0,0,0,1,0,0,2,0,0
3216,205,529,107,422,4,418,2,416,100,141,91,43,27,8,0,0,0,0,0,0,0,0,0,0,3,0,3
3217,205,823,241,582,1,581,4,577,196,162,98,63,25,12,0,0,0,0,1,0,0,0,1,0,6,1,12
3218,205,695,190,505,3,502,7,495,147,136,105,46,22,20,0,2,0,0,0,0,0,2,0,2,7,1,5
3219,205,753,196,557,7,550,3,547,151,145,104,87,36,11,0,0,0,0,0,0,1,0,1,1,4,2,4
3220,205,739,198,541,6,535,3,532,147,179,112,43,28,13,0,0,0,0,0,0,0,0,0,0,7,0,3
3221,205,830,232,598,11,587,7,580,187,175,123,47,31,11,0,0,0,0,0,1,0,0,1,1,1,1,1
3222,205,784,189,595,5,590,11,579,151,170,103,93,39,12,0,1,0,0,0,0,0,0,0,0,1,1,8
3223,205,873,194,679,5,674,11,663,164,183,121,116,31,25,2,1,0,0,0,0,0,4,1,2,4,0,9
3224,205,763,204,559,6,553,2,551,172,179,83,57,31,12,1,0,0,0,0,1,0,0,0,0,7,0,8
3225,205,800,232,568,3,565,4,561,165,183,107,56,25,12,0,0,0,0,1,1,0,0,2,0,4,0,5
3226,205,845,186,659,6,653,10,643,146,191,118,114,48,13,0,0,0,0,0,1,0,1,2,0,5,1,3
3227,205,809,185,624,2,622,5,617,133,216,109,107,25,18,0,0,1,0,0,0,0,2,1,0,2,1,2
3228,205,859,168,691,8,683,10,673,168,155,138,144,27,14,0,0,0,0,0,1,1,1,1,1,12,1,9
3229,205,837,136,701,8,693,9,684,196,180,129,120,26,16,1,0,0,0,1,0,0,1,1,2,8,0,3
3230,205,866,273,593,6,587,9,578,119,180,126,103,23,14,0,0,0,1,0,0,0,0,0,2,2,1,7
3231,205,882,258,624,2,622,7,615,156,180,132,90,23,10,0,0,0,0,0,0,0,0,1,5,8,1,9
3232,205,700,138,562,6,556,6,550,137,139,110,105,30,16,1,0,0,0,1,0,0,0,1,0,6,1,3
3233,205,741,153,588,6,582,8,574,147,171,111,95,27,10,0,0,0,1,0,0,0,0,1,1,7,0,3
3234,205,718,144,574,2,572,6,566,179,128,91,103,28,18,0,0,0,1,1,0,0,2,1,1,5,0,8
3235,205,780,162,618,8,610,7,603,162,143,131,106,27,17,0,0,0,0,0,2,0,1,0,2,2,2,8
3236,205,790,149,641,5,636,8,628,178,155,86,136,36,20,0,1,0,1,2,1,0,1,0,2,2,2,5
3237,205,718,138,580,6,574,6,568,158,156,106,103,25,10,1,0,0,1,0,0,0,0,1,0,2,1,4
3238,205,647,164,483,2,481,7,474,125,145,88,77,16,9,2,1,0,0,0,0,1,0,1,0,1,1,7
3239,205,636,163,473,2,471,9,462,116,152,82,63,22,14,1,0,0,1,1,0,1,0,0,1,3,0,5
3240,205,696,132,564,4,560,5,555,155,141,114,95,30,9,0,1,0,0,1,0,0,0,0,0,3,3,3
3241,205,738,154,584,4,580,10,570,162,143,117,96,27,11,1,0,0,0,1,0,0,0,0,1,5,1,5
3242,205,603,119,484,9,475,3,472,121,103,97,98,17,18,1,0,0,0,0,2,0,2,0,0,3,0,10
3243,205,592,140,452,4,448,5,443,138,122,65,74,22,9,0,1,1,0,0,0,0,1,1,0,3,0,6
3244,206,792,247,545,1,544,9,535,226,98,74,91,12,15,1,1,1,0,0,0,0,0,1,2,3,0,10
3245,206,832,278,554,2,552,16,536,206,103,73,114,13,10,2,1,0,0,1,0,0,1,0,0,6,1,5
3246,206,820,282,538,8,530,1,529,120,183,126,40,41,8,0,2,0,0,0,1,0,3,0,1,4,0,0
3247,206,801,311,490,5,485,4,481,99,169,116,48,36,6,0,1,0,0,0,0,1,0,1,0,0,3,1
3248,206,598,174,424,7,417,2,415,126,114,80,64,13,6,0,0,0,0,1,0,0,0,0,0,3,1,7
3249,206,749,206,543,2,541,3,538,153,142,98,94,22,18,0,0,0,0,0,1,0,0,0,0,4,0,6
3250,206,651,187,464,6,458,5,453,142,125,76,71,15,14,0,0,0,0,0,0,2,0,0,0,4,0,4
3251,206,603,192,411,4,407,3,404,123,104,76,66,15,7,1,0,0,0,2,0,0,1,0,1,5,0,3
3252,206,544,172,372,0,372,5,367,108,91,56,70,25,8,0,0,0,0,0,0,0,0,0,0,2,0,7
3253,206,557,190,367,2,365,4,361,136,66,69,63,10,6,0,1,0,0,0,0,0,0,1,1,3,1,4
3254,206,747,270,477,6,471,2,469,171,83,69,102,23,9,2,0,0,0,1,0,0,0,0,0,3,0,6
3255,206,714,224,490,5,485,3,482,172,88,83,97,19,12,1,0,0,0,1,0,0,2,0,0,4,0,3
3256,206,820,324,496,5,491,1,490,159,92,77,121,13,17,0,0,0,0,0,0,1,0,0,1,4,0,5
3257,206,906,329,577,5,572,9,563,197,94,85,135,16,21,0,0,0,1,0,0,0,1,1,0,7,0,5
3258,207,712,190,522,2,520,8,512,120,168,111,53,27,19,2,0,0,0,0,0,0,0,1,0,5,2,4
3259,207,655,207,448,3,445,5,440,123,122,91,56,19,15,2,0,0,0,1,0,0,0,1,0,4,1,5
3260,207,735,299,436,5,431,5,426,103,136,121,28,23,6,0,0,0,0,0,0,0,1,1,0,5,1,1
3261,207,675,247,428,3,425,1,424,128,118,96,44,20,12,0,0,0,0,0,0,0,1,0,0,3,0,2
3262,207,681,280,401,7,394,4,390,120,130,68,35,13,11,1,0,1,0,0,0,0,1,1,1,4,1,3
3263,207,948,281,667,10,657,3,654,175,216,139,56,32,15,0,0,1,0,0,1,1,0,2,1,9,2,4
3264,207,946,331,615,7,608,7,601,277,117,85,71,19,11,0,1,0,0,1,0,0,0,0,1,12,0,6
3265,207,850,311,539,9,530,3,527,197,130,92,55,12,18,1,0,0,0,0,0,0,0,0,1,6,1,14
3266,207,523,173,350,4,346,0,346,82,110,91,34,18,4,0,1,0,0,0,0,0,1,0,0,2,1,2
3267,207,536,197,339,4,335,1,334,106,102,70,30,11,6,1,1,0,0,1,0,0,0,0,1,4,0,1
3268,207,899,333,566,2,564,1,563,82,214,154,49,32,17,2,1,0,1,1,0,0,1,0,3,5,0,1
3269,207,524,200,324,2,322,1,321,50,116,101,22,12,5,1,3,1,0,0,0,0,0,0,1,7,0,2
3270,207,558,208,350,1,349,1,348,52,109,112,41,21,2,1,0,0,0,1,1,0,1,1,0,5,0,1
3271,207,736,267,469,3,466,8,458,112,155,108,46,21,8,1,0,0,0,0,0,1,1,0,0,3,1,1
3272,207,677,223,454,1,453,4,449,123,150,100,32,26,7,0,1,0,1,0,0,0,0,1,1,3,1,3
3273,207,711,241,470,5,465,2,463,191,116,82,40,15,2,3,1,0,0,1,1,0,1,0,2,8,0,0
3274,207,519,147,372,1,371,4,367,164,75,53,31,18,13,0,0,0,0,0,1,0,0,0,1,4,0,7
3275,207,870,301,569,4,565,1,564,166,196,100,53,22,9,4,0,0,0,0,0,0,0,0,1,7,1,5
3276,207,605,192,413,8,405,8,397,132,121,64,43,17,10,0,0,0,0,2,1,0,0,3,0,1,0,3
3277,207,652,184,468,4,464,4,460,140,137,96,46,22,12,0,0,0,0,0,0,0,1,0,0,3,0,3
3278,207,827,250,577,8,569,7,562,164,183,110,64,23,7,0,1,0,0,0,1,1,2,0,0,2,2,2
3279,207,766,287,479,4,475,3,472,136,141,105,39,19,12,1,0,0,0,0,1,0,1,1,2,7,0,7
3280,207,747,234,513,5,508,10,498,163,149,98,55,17,6,0,0,0,0,0,0,0,0,1,1,8,0,0
3281,207,528,111,417,1,416,1,415,151,106,85,39,18,9,0,0,0,0,0,0,0,0,1,0,4,0,2
3282,207,560,132,428,2,426,8,418,150,109,77,46,17,10,0,0,0,0,0,0,0,1,0,0,3,0,5
3283,207,979,396,583,1,582,4,578,160,185,125,66,20,8,3,0,0,0,2,0,0,2,2,0,4,0,1
3284,207,642,214,428,4,424,1,423,135,118,92,44,19,8,1,0,0,0,0,0,0,0,2,1,1,0,2
3285,207,636,210,426,8,418,4,414,128,98,117,37,20,4,0,0,0,0,0,2,0,0,2,0,5,1,0
3286,207,931,279,652,4,648,6,642,318,124,103,51,18,13,0,0,0,0,0,0,0,0,0,1,7,1,6
3287,207,538,137,401,2,399,6,393,152,90,57,71,6,7,0,2,0,0,0,0,0,0,0,0,4,0,4
3288,207,566,153,413,2,411,3,408,177,96,45,51,20,7,1,0,0,0,0,0,0,1,0,0,4,0,6
3289,208,493,111,382,3,379,7,372,152,84,71,30,18,8,0,0,0,0,0,0,1,0,0,4,0,0,4
3290,208,541,117,424,5,419,0,419,159,100,69,37,30,10,1,0,0,1,1,0,0,1,1,2,2,1,4
3291,208,563,122,441,1,440,5,435,154,98,63,78,10,15,0,0,0,0,0,1,0,1,0,3,3,2,7
3292,208,732,201,531,5,526,5,521,181,146,53,77,23,16,1,0,0,0,2,1,0,0,0,1,8,0,12
3293,208,717,176,541,2,539,5,534,184,149,65,75,19,19,0,0,0,1,0,0,0,0,0,2,9,0,11
3294,208,848,261,587,2,585,4,581,235,138,78,77,23,7,1,0,0,0,0,1,2,0,0,0,3,0,16
3295,208,837,214,623,2,621,8,613,247,135,85,82,23,17,0,1,0,2,0,2,0,1,0,0,5,0,13
3296,208,674,141,533,4,529,6,523,199,126,48,103,18,13,2,0,0,0,0,1,0,0,0,0,5,0,8
3297,208,731,164,567,1,566,6,560,227,135,68,91,15,6,0,1,0,1,0,0,0,1,0,0,3,0,12
3298,208,763,174,589,4,585,7,578,177,162,90,101,27,8,0,0,0,1,2,1,0,1,2,0,3,0,3
3299,208,740,191,549,1,548,7,541,163,156,78,91,25,14,1,0,0,0,0,1,0,1,0,1,6,1,3
3300,208,647,165,482,2,480,6,474,214,129,40,56,14,10,0,0,0,0,0,0,0,0,1,0,3,0,7
3301,208,723,191,532,3,529,5,524,224,137,57,63,15,8,0,0,1,0,2,0,1,0,2,1,6,0,7
3302,211,553,145,408,0,408,6,402,173,86,48,72,9,8,0,1,0,0,0,0,0,1,0,1,1,0,2
3303,211,522,142,380,3,377,7,370,158,85,45,53,10,7,0,0,0,0,0,0,0,1,0,1,6,0,4
3304,211,649,126,523,3,520,4,516,213,132,55,76,15,10,0,0,0,0,1,2,0,0,0,1,2,0,9
3305,211,599,132,467,2,465,7,458,180,117,56,69,18,12,0,0,0,0,0,2,0,0,0,0,2,0,2
3306,211,561,127,434,5,429,7,422,174,104,54,58,14,8,1,0,0,0,2,0,0,0,0,0,4,1,2
3307,211,495,111,384,2,382,3,379,165,83,47,54,8,13,1,0,0,0,0,0,0,0,0,0,1,0,7
3308,211,991,209,782,5,777,9,768,329,177,95,98,38,12,1,0,0,0,0,0,0,1,0,0,2,1,14
3309,211,631,129,502,2,500,7,493,199,93,62,91,14,13,0,1,0,0,1,0,0,0,0,1,4,0,14
3310,211,690,153,537,2,535,9,526,235,111,58,88,14,10,0,0,0,0,0,0,0,0,0,0,3,0,7
3311,211,512,111,401,1,400,3,397,157,89,50,69,10,11,0,0,0,1,0,0,0,0,0,0,3,0,7
3312,211,517,116,401,3,398,4,394,149,92,51,74,7,10,0,2,0,0,0,0,2,1,0,0,2,0,4
3313,211,770,169,601,3,598,4,594,255,142,92,72,7,9,1,0,0,0,1,0,0,0,0,1,7,0,7
3314,211,702,165,537,3,534,11,523,205,102,93,78,16,11,1,0,0,0,0,0,0,1,1,0,2,0,13
3315,211,572,123,449,4,445,1,444,171,117,59,62,11,13,0,0,0,0,0,0,0,0,0,1,1,0,9
3316,211,533,119,414,4,410,4,406,166,100,59,43,15,11,0,0,0,0,0,0,0,1,0,3,2,1,5
3317,211,533,128,405,4,401,2,399,170,95,47,47,13,8,0,1,0,0,0,1,0,1,0,0,7,0,9
3318,211,499,123,376,3,373,3,370,173,62,49,64,8,7,1,0,0,0,1,0,0,0,0,0,0,0,5
3319,211,654,150,504,6,498,7,491,199,102,79,82,8,8,0,0,0,0,1,0,0,0,0,0,5,0,7
3320,211,642,143,499,7,492,5,487,210,83,81,64,21,11,1,0,0,0,1,0,0,0,0,0,4,0,11
3321,211,775,170,605,5,600,9,591,180,150,112,90,28,16,0,0,0,0,0,0,0,0,1,0,4,0,10
3322,211,537,128,409,2,407,4,403,148,105,69,44,16,11,0,0,0,0,0,0,0,2,0,0,3,0,5
3323,211,562,118,444,2,442,1,441,151,109,97,48,17,10,0,0,0,0,0,0,0,0,0,0,4,0,5
3324,211,756,163,593,2,591,8,583,235,131,93,91,15,6,0,0,0,1,0,0,0,0,1,0,3,0,7
3325,211,807,205,602,7,595,4,591,215,160,84,67,21,26,0,2,0,0,0,0,0,0,0,0,3,1,12
3326,212,606,280,326,0,326,2,324,80,94,73,42,17,10,3,0,0,0,1,0,0,1,0,2,0,1,0
3327,212,647,303,344,0,344,2,342,68,121,64,40,20,15,4,0,0,0,0,1,1,0,0,1,6,0,1
3328,213,533,193,340,1,339,2,337,91,92,82,32,20,9,0,0,1,0,0,1,0,0,0,1,5,2,1
3329,213,602,219,383,0,383,1,382,114,93,79,53,20,10,1,0,0,0,0,1,0,1,0,0,10,0,0
3330,213,572,227,345,6,339,4,335,99,107,65,21,21,7,2,1,0,0,0,0,1,0,0,0,10,0,1
3331,213,518,210,308,6,302,2,300,90,90,67,23,8,7,0,1,0,0,3,0,0,0,3,1,7,0,0
3332,213,974,338,636,9,627,9,618,166,168,135,75,37,9,1,0,0,0,0,0,0,1,0,4,16,0,6
3333,213,679,217,462,3,459,3,456,148,118,79,69,22,6,0,0,0,0,0,0,0,0,0,0,10,0,4
3334,213,701,222,479,7,472,5,467,162,127,85,47,16,12,0,1,0,0,1,0,0,0,0,0,11,0,5
3335,213,885,310,575,8,567,10,557,184,144,89,79,28,11,0,1,0,0,0,0,0,2,1,3,8,0,7
3336,214,599,173,426,4,422,4,418,94,124,114,52,13,10,1,0,0,0,0,0,0,0,0,3,5,0,2
3337,214,650,200,450,8,442,2,440,110,119,94,67,24,12,2,0,0,0,0,0,1,1,0,1,7,1,1
3338,214,791,280,511,6,505,11,494,118,145,115,56,33,12,1,0,0,0,1,0,1,0,1,0,10,1,0
3339,214,598,178,420,11,409,3,406,122,100,60,72,16,11,1,1,0,0,0,0,0,0,4,0,11,0,8
3340,214,650,171,479,7,472,8,464,155,109,74,73,26,15,0,0,0,0,0,0,0,0,0,1,5,4,2
3341,214,909,245,664,2,662,9,653,213,154,108,123,29,9,0,0,0,0,1,0,0,1,0,3,9,0,3
3342,214,596,170,426,1,425,3,422,129,104,72,73,22,9,1,1,0,0,0,0,0,0,2,0,4,1,4
3343,214,524,151,373,5,368,1,367,121,88,63,66,18,9,0,0,0,0,0,0,0,0,0,0,0,0,2
3344,214,1027,258,769,7,762,4,758,216,153,156,158,33,23,0,0,0,0,1,0,0,0,0,0,10,2,6
3345,214,976,233,743,6,737,12,725,179,145,157,168,36,15,2,0,1,0,0,1,0,1,2,1,10,1,6
3346,215,509,142,367,2,365,9,356,144,86,40,54,12,11,0,0,0,0,0,0,0,1,0,0,3,0,5
3347,215,555,145,410,4,406,2,404,184,75,50,59,12,6,0,0,0,0,0,1,0,1,0,1,5,2,8
3348,215,873,195,678,2,676,9,667,304,115,49,159,12,17,0,0,0,0,0,0,0,0,0,0,4,0,7
3349,215,800,151,649,4,645,8,637,252,117,68,143,12,23,0,0,0,1,2,1,0,0,0,1,3,1,13
3350,215,995,200,795,5,790,6,784,338,140,62,185,6,29,0,0,0,0,0,1,0,1,0,0,4,0,18
3351,215,478,136,342,2,340,2,338,130,68,48,72,7,5,0,0,0,0,0,2,0,0,1,0,3,1,1
3352,215,536,156,380,2,378,2,376,151,72,47,85,3,6,0,0,0,0,1,0,0,0,0,0,3,1,7
